000000000000
000XX0000000
0000000X0000
000000000000
000000000000
00000000000X
000000000000
000000000000
000000000000
00000000000X
X00000000000
000000000000
000000000000
000000000000
000000000X00
000000000000
000000X000X0
000000000000
000000000LLL
000000000LLL
0000X0000LLL
