000000X00000
000000000000
000000000000
000000000000
000000000000
000000000000
0000000X0000
00000000000X
000000000X00
000000000000
000X00000000
X00000000000
00X000000000
000000000000
000000000000
000000000000
000000000000
000000000000
000000000LLL
00000X000LLL
000X00X00LLL
