0000000000X0
000000000000
000000000000
00X000000X00
0000XX000000
000000000000
0000000000X0
000000000000
00000X000000
000000000000
000000000000
000000000000
000000000000
000000000000
000000000000
000000000000
000000000000
00X0X0000000
000000000LLL
00X000000LLL
000000000LLL
