00000000000X
00000X000000
000000000000
000000000000
000000000000
0000000000X0
0000000X0000
000000000000
000000000000
0X00X0000X00
000000000000
000000000000
000000000000
000000000000
X00000000000
000000000000
00000X000000
000000X00000
000000000LLL
000000000LLL
000000000LLL
