00X000X00000
000000000000
000000000000
000X00000000
000000000000
000X00000000
0000000000X0
000000000000
000000000000
000000000000
000000000000
000000000000
000000000000
000XX0000000
000000000000
000000000000
000000000X00
00000X000000
000000000LLL
000000000LLL
000000000LLL
