0000X0000000
000000000000
000000000000
00000000000X
000000000000
00000000X000
000000000000
0000X00X0000
000000000000
000000000000
000000000000
000000000000
000000000000
000000000000
000X00000000
000000000000
0X0X000000X0
000000000000
000000000LLL
000000000LLL
0000X0000LLL
