0000000000X0
000000000000
000000000000
X00000000000
000000000000
000000000000
000000000000
X00000000000
000000000000
000000000000
000000000000
000000000000
0000X0000000
0000000000X0
000X00000000
000000000X00
000000000000
000000000000
00X000000LLL
000000X00LLL
000000000LLL
