000000000000
000000000X00
000000000000
0000000000X0
000000000000
000000000000
0X000000X000
000000000000
000000000000
000000000000
000000000000
X00000000000
0X00X0000000
000000000000
000000000000
000000000000
000000000X00
000000000000
000000000LLL
000000000LLL
X00000X00LLL
