000000000000
000000000000
X00000000000
000000000000
00000000000X
000000000000
000000000000
000000000000
000000000X00
0000000X0000
000000000000
000000000000
000000000000
000000000000
000000000000
0000000X0000
000X00000000
000000000000
X00000000LLL
0000000X0LLL
000000000LLL
