000000000000
0000000000X0
000000000000
000X00000000
000000000000
000000000000
000X00X00000
000000000000
000000000000
0000000X0000
0X00X0000X00
000000000000
000000000000
000000000000
000000000000
000000000000
000000000000
000000000000
000000000LLL
00000X000LLL
000000000LLL
