000000000000
000000000000
000000000000
000000000000
00000000X000
X00000000000
000000000000
00X000000000
000000000000
000000000000
000000000000
000000000000
00X000000000
0X0000000000
000000000000
000X00000000
000000000000
000000000000
00X000000LLL
0000000X0LLL
X00000X00LLL
