000000000000
0X00000000X0
000000000000
000000000000
000000000000
000000000000
0000000X0000
000000000000
X000000X0000
00000X000000
000X00000000
000000000000
000000000000
000000000000
0000000000X0
000000000000
000000000000
000000000000
000000000LLL
000000X00LLL
0000000X0LLL
