000000000000
000X00000X00
000X00000X00
00000X000000
000000000000
000000000000
000000000000
000000000000
000000000000
00000X000000
000000000000
00000X000000
000000000X00
000000000000
000000000000
000000000000
000000000000
000000000000
000X000X0LLL
000000000LLL
000000000LLL
