000000000000
000000000000
000000000000
0000X000X000
000000000000
00000X000000
000000000000
000000000000
000000000000
000000000000
00X000000000
000000000000
0000X0000000
000000000000
000000000000
0000000000X0
X00000000X00
000000000000
000000000LLL
X00000000LLL
000000000LLL
