000000000000
00000XX00000
X000000000X0
00X000000000
000000000000
000000000000
00X000000000
000000000000
000000000000
000000X00000
000000000000
000000000X00
000000000000
000000000000
000000000000
000000000000
000000000000
00000000000X
000000000LLL
000000000LLL
000000000LLL
