00000000000X
000000000000
000000X0000X
000000000000
000000000000
000000000000
000000000000
000000000000
000000000000
000000000000
000000000000
00000X000000
000000000000
0X0000000000
00X000000000
X00000000000
000000000000
00X000000000
0X0000000LLL
000000000LLL
000000000LLL
