00X000000000
000000000000
000000000000
000000000000
000000000000
000000000X00
00X000000000
000000000000
000000000000
00000000X000
000000000000
000000000000
0000X0000000
00000X0X0000
000000000000
00000000X000
000000000000
0000000X0000
000000000LLL
X00000000LLL
000000000LLL
