000X00000000
000000000000
00X000000000
000000000000
000000000000
000000000000
000000000000
000000000000
0000XX00000X
000000000000
000000000000
00000X000X00
000000000X00
000000000000
000000000000
0000000000X0
00000000X000
000000000000
000000000LLL
000000000LLL
000000000LLL
