000000000X00
00000000X000
000000000000
000000000000
000000000000
000000000000
000000000000
000000000000
00X000000000
000000000000
000X00X00000
000000000000
000000000000
000000000000
X00000000000
X0000000X000
000000000000
X00000000000
X00000000LLL
000000000LLL
000000000LLL
