0X00X0000000
X00000000000
000000000000
000000000000
000000000000
000000000000
000000000000
000000000X00
00000000000X
00000000000X
00000000000X
000000000000
000000000000
000000000000
000000000000
000000000000
000000000000
00000X000000
00X000000LLL
000000000LLL
000000000LLL
