X00000000000
00000000X000
000000000000
000000000000
000000000000
000000X00000
000000000000
0000X0000000
000000000000
000000000000
000000000000
00000000X000
0000000000X0
000000000000
00000X000000
X00000000000
00000000X000
000000X00000
000000000LLL
000000000LLL
000000000LLL
