000000000000
000000X00000
000000000000
000000000000
000000000000
000000000000
000000X00000
00000X0X0000
000000000000
000000000000
000000000000
000000000000
000000000000
X00X00000000
000000000000
000000000000
000000000000
00000X0X0000
000000000LLL
000000000LLL
0X0000000LLL
