00000000X000
000000000000
000000000000
000000000000
000000000000
000000000000
000000000X00
000000000000
000000000000
0000000X0000
000000000000
000000000000
000000X00000
00000X000000
000000000000
000000000000
0000000X000X
000000X00000
00XX00000LLL
000000000LLL
000000000LLL
