000000000000
000000000000
00000000000X
000000000000
X00000000000
000000000000
00000000000X
X00000000000
000000X00000
0X0X00000000
000000000000
000000000000
000000000000
000000000X00
000000000000
000000000000
00XX00000000
000000000000
000000000LLL
000000000LLL
000000000LLL
