0000X000000X
000000000000
000000000000
00000000X000
000000000000
000000000000
00000X000000
000000000000
000000000000
000000000000
000000000000
000000X00000
0X0000000000
0X0000000000
X00000000000
000000000000
000000000000
000000000000
000000000LLL
000000000LLL
000000000LLL
