XX0000000000
000000000000
000000000000
000000000000
000000000000
X00X00000000
000000000000
000X00000000
000000000000
000000X0X000
000000000000
000000000000
000000000000
00000000XX00
000000000000
00X000000000
000000000000
000000000000
000000000LLL
000000000LLL
000000000LLL
