X00000000000
000000X0X000
000000000000
0000000000X0
000000000000
000000000000
000000000000
0000X0000000
000000000000
000000000000
000000000000
000000000000
000000X00000
00X00X000000
000000000000
00000000000X
000000000000
000000000000
000000000LLL
00000X000LLL
000000000LLL
