000000000000
000000X00000
000000000000
0000000X0000
00000000X000
000000X00000
000000000000
000000000000
000X0000X000
000000000000
000000000000
0X0000000000
000000000000
000000000000
000000000000
000000000000
000000X00000
000000000000
000000000LLL
00000X000LLL
000000000LLL
