00X000000000
000000000000
0000000000X0
0X0000000000
000000000000
000000000000
0000X0000000
000000000000
000X00000000
00X000000000
000000000000
000000000000
000000000000
000000000000
0000X0000000
00X00X0000X0
000000000000
000000000000
000000000LLL
000000000LLL
000000000LLL
