000000000000
000000000000
000000000000
000000000000
000000000000
000000000000
000000000000
0000000000X0
X00000000000
000000000000
000000000X00
000000000000
000000X00000
000X00000000
00000000000X
000000000000
000X00X00000
000000000000
0000X0000LLL
000000000LLL
000000000LLL
