000000000000
000000000000
000000000000
000000000000
000X00000000
000000000000
0000X0XX0000
000000000000
000X00000000
000000000000
000000000000
0X0000000000
000000000000
000000000000
00X000000000
0X0X00000000
00000000X000
000000000000
000000000LLL
000000000LLL
000000000LLL
