000X00000000
000000000000
00X000000000
X00000000000
0000000XX000
000X00000000
000000000000
0X0000000000
000000000000
000000000000
00X000000000
000000000000
000000000000
000000000000
00X000000000
000000000000
000000000000
00X000000000
000000000LLL
000000000LLL
000000000LLL
