000000000X00
000000000000
000000000000
000000X00000
000000000000
00000000X000
000000000000
000000000000
00000X000000
000000000000
00X000000000
000000000000
000X00000000
000000000000
00X000000000
0000000000X0
000000000000
000000000000
000000000LLL
00X000000LLL
000000000LLL
