0000000X0000
000000000000
000000000000
000000X00000
000000000000
000000000000
0000000X0000
000000000000
000000000000
000X00X00000
0000000X0000
00X000000000
000000000000
000000000000
000000000000
000000000000
000000000000
000000000000
000000000LLL
00X000X00LLL
000000000LLL
