000000000000
000000000000
000000000000
00000000X000
000000000000
000000000000
0000000X0000
000000000000
000000000000
000000XX0X00
X00000000000
X00000000000
000000000000
0X0000000000
0000000000X0
000000000000
000000000000
000000000000
000000000LLL
00000X000LLL
000000000LLL
