000000000000
0000000000X0
00000000X000
000000000000
000000000000
000000000000
00000000X000
000000000000
000000000000
0000000000X0
000000000000
000000000000
000000X00000
000000000000
0000000000X0
000000000000
00000000X000
000000000000
000000000LLL
000000X00LLL
0000000X0LLL
