000000000000
000000000000
0000000000X0
00X000000000
00X000000000
000000000000
0000000X00X0
0000000X0000
00000000X000
000000000000
000000000000
000000000000
000000000000
000000000000
000000000000
000000000000
000000000000
000000000000
000000000LLL
00000X000LLL
000X00000LLL
