000000000000
000000X00000
000000000000
000000000000
000000000000
0000000X0000
000000000000
000000000000
0000000X00X0
X00000X000X0
000000X00000
0000000X0000
000000000000
000000000000
000000000000
000000000000
0000000000X0
000000000000
000000000LLL
000000000LLL
000000000LLL
