000000000000
000000000000
000000000000
000000000000
000000000000
0000000X0000
000000000000
000000000000
000000000000
000000000000
00000X0000X0
000000000X00
00000000X000
000000000XX0
000000000000
00000000000X
000000000000
000000X00000
000X00000LLL
000000000LLL
000000000LLL
