000000000000
000000000X00
00000000000X
000000000000
0X000X000000
X00000000000
0000000000X0
000000000000
000000000000
000000000000
000000000000
000000X00000
0000000X0000
0000000X0000
000000000000
000000000000
000000000000
000000000000
000000000LLL
000000000LLL
0X0000000LLL
