000000000000
X0000X000000
000000000000
00000000000X
000000000000
000000000000
0X00000X0000
000000000000
00X000000000
000000000000
00000000X000
0000X0000000
000000000000
0000000000X0
000000000000
000000000000
000000000000
000000000000
000000000LLL
000000000LLL
0000X0000LLL
