000000000000
000000000000
000000000000
00X000000000
00000000000X
000000000X00
00000X000000
000000000000
0000000X0000
00000X000000
000000000000
000000000000
000000000000
00000000000X
000000000000
000000000000
000000000000
000000000000
000000000LLL
X0000X000LLL
000000000LLL
