000000000000
000000X00000
000000000000
000000000000
000000X00000
0000X000000X
000000000000
000000000000
000000000000
000000000000
000000000000
0000000X0000
0000X00X0000
000000000000
000000000X00
000000000000
00000000000X
000000000000
000000000LLL
000000000LLL
X00000000LLL
