0000000000X0
000000000000
000000000000
000000000000
000000000000
000000000000
000000000000
000000000000
000000000000
0000X0000000
000X0000X000
000000000000
000000000000
000000000000
000000000000
X00000000000
X000X0000000
000000000000
X00000X00LLL
000000X00LLL
000000000LLL
