000000000000
000000000000
000000000000
000000000000
000000000000
000000000000
000000000000
X00000000000
0X0000000XX0
0000000X0000
000000000000
000000000000
00000000000X
000000000000
00X000000000
00X000000000
000000000000
000000X00X00
000000000LLL
000000000LLL
000000000LLL
