00000X000000
00000X00X000
000000000000
000000000000
X00000000000
00000000X000
000000000000
000000000000
000000000000
000000000000
000000000000
000000000000
00000000000X
000X00000000
000000000000
000000000000
000000000000
000000000X00
X00000000LLL
000000000LLL
000000000LLL
