000000000000
00000000X000
000X0000000X
000000000000
000000000000
0000000X0000
000000000000
000000000000
000000000000
000000000000
000000000X00
0X000000X000
000000000000
000000000X00
000000000000
000000000000
0X0000000000
000000000000
000000000LLL
000000000LLL
0X0000000LLL
