000000X00000
0000000000X0
000000000000
000000000000
000X00000000
0000000000X0
000000000000
000000000000
00000000000X
000000000000
000000000000
000000000000
000000000000
00000000X000
0000X0000000
000000000000
0X00X0000000
000000000000
0000000X0LLL
000000000LLL
000000000LLL
