000000000000
000000000000
0000000X0000
0X0000X000X0
000X00000000
000000000000
00000X000000
000000000000
00000X000000
000000000000
000000000000
000000000000
000000000000
000000000000
000000X00000
000000000000
00X000000000
00000000X000
000000000LLL
000000000LLL
000000000LLL
