000000000000
000000000000
00000X000000
00000000X000
00X000000000
000000000000
X00000000000
000000000000
000000000000
000000000000
000000000000
000000000000
0000000X0000
000000000000
000000000000
00X0X0000000
000000000000
00000X000000
0000X0000LLL
0X0000000LLL
000000000LLL
