0X0000X00000
0000000000X0
000000000000
0000000X0000
000000000000
000000000000
00X000000000
000000000000
000000000000
000000X00X00
000000000000
000000000000
000000000000
000000000000
000000000000
000000000000
000000000000
X0000X000000
000000000LLL
000000000LLL
00000X000LLL
