0000000000X0
00000000000X
000000000000
X00000000000
000000000000
000000000000
X00000000000
000000000000
000000000000
000000000000
000000000000
000000000000
000000000000
0X0000X00000
000000000000
0000X0000000
000000000000
000000000X00
0000000X0LLL
X00000000LLL
000000000LLL
