000000000000
X00000000000
00000000000X
0000X0000000
000000000000
000000000000
000X00000X00
000000000000
000000000000
000000000000
000000000000
000000000000
000000000000
000000000000
000000000000
000000000000
0X00X0000000
00000X000000
00000X000LLL
000000000LLL
000000000LLL
