000000000000
X0000X000000
0X0000000000
000000000X00
000000000000
000000000000
0000000X00X0
000000000000
000000X00000
000000000000
000000000000
000000000000
000000000000
000000000000
000000000000
000000X00000
000000000000
000000000000
000000000LLL
000000000LLL
000000000LLL
