00000X000000
X00000000000
000X00000000
00000X000000
0000000000X0
000000X00000
000000000000
000000000000
000000000000
000000000000
000000000000
000000000000
000000X00000
X00000000000
0000000000X0
000000000000
000000000000
000000000000
00000X000LLL
000000000LLL
000000000LLL
