000000000000
000000000000
000000000000
0000X0000000
000000000000
000000000000
000000000000
000000X000X0
000000000000
000000000000
000000000000
000X00000000
0X00000X0000
000000X0000X
000000000000
00000X000000
000000000000
000000000000
000000000LLL
000000000LLL
0000X0000LLL
