000000X00000
0000X0000X00
000000000000
000000000000
000000000000
000000000000
000000000000
00X000000000
000000000000
0000X0000X00
0X0000000000
000000000000
000000000000
00X00X0000X0
000000000000
000000000000
000000000000
000000000000
000000000LLL
000000000LLL
000000000LLL
