0000000X0000
000000000000
000000000000
000000000000
000000000000
000000000000
000000000000
00000000XX00
00000000000X
000000000X00
000000000000
000000000000
000000000000
000000000000
000000000000
000000000000
000000000000
000X00000000
000000000LLL
000000000LLL
00000X000LLL
