000000000000
000000000000
0000X0000000
000000000000
000000000000
000000000000
00000000X000
0X000000000X
000000000000
000000000000
00000000000X
0X0000000000
000000000000
000000000000
000000X00000
000000000000
000000000000
000000000000
00000X000LLL
0X0000000LLL
000000000LLL
