000000000000
000000000X00
0000000X0000
000000000000
00X000000000
000000000000
000000000000
00000000X000
000000000000
000000000000
0000000000X0
00000X000000
000000000000
000000000000
000000000000
000000000000
000000000000
000000000000
0000X0X00LLL
000000000LLL
00000000XLLL
