0000000000X0
000000000000
000000000000
000000000000
00000000X000
00000X000000
000000000000
000000000000
000000000000
000000000000
0000000X0000
X00000X00000
000000000000
000000000000
0000000000X0
00X000000000
0000000000X0
000000000000
0X0000000LLL
000000000LLL
000000000LLL
