000000000000
000000000000
000000000000
000000000000
000000000000
000000000000
000000000000
000000000X00
000000000000
0000X00X0000
000000000000
000000000000
000000000000
0X000X000000
000000000000
00000X000000
000000000000
00000X000000
0X0000000LLL
000000000LLL
000000000LLL
