000000000000
00000000X000
000000000000
000000000X00
0000X0000000
000000000000
0X0000000000
000X00000000
000000000000
0000X0000000
000000000000
000000000000
000000000000
000000000000
000000000000
000000000000
0000XX000000
0000X0000000
000000000LLL
000000000LLL
000000000LLL
