000000000000
000000000000
000000000000
0000000X0000
000000X000X0
000X000X0000
00X000000000
0000X0000000
000000000000
000000000000
000000000000
000000000000
000000000000
000000000000
000000000000
000000000000
000000000000
0XX000000000
000000000LLL
000000000LLL
000000000LLL
