000000000000
000000000000
000000000000
000000000000
0X00XX000000
000000000000
000000000000
X00000000000
000000000000
000000000000
000000000000
000000000000
000000000000
000000000000
0000000X0000
000000000000
000000000000
00000X000000
000000000LLL
000000000LLL
0X0000X00LLL
