000000000000
000000000000
0000X00X0000
000000000000
0000000X000X
000000000000
0X0000000000
000000000000
000000000000
000000000000
0X0000000000
0000X00X0000
000X00000000
000000000000
000000000000
000000000000
000000000000
000000000000
000000000LLL
000000000LLL
000000000LLL
