000000000000
0000000X000X
0X0000000000
000000000000
000000000000
000000000000
000000000000
000000000000
000000000000
000000000000
000000000000
X0000X000000
0000XX000000
000000000000
000000000000
000000000000
000000000000
0000X000000X
000000000LLL
000000000LLL
000X00000LLL
