000000000000
000X00000000
000000000000
0000000000X0
000000000000
000000000000
000000X00000
000000000000
000000000000
000000000000
0000000000X0
000000000000
X00000000000
000000000000
0X0X00000000
000000000000
000000000000
0X0000000000
000000000LLL
000000000LLL
000000000LLL
