X00000000X00
00X000000000
000000000000
000000000000
00000000X000
00000X000000
00000000X000
000000000000
000000000000
000000000X00
000000000000
000000000000
000000000X00
000000000000
00000X000000
000X00000000
000000000000
000000000000
000000000LLL
000000000LLL
000000000LLL
