0000000000X0
000000000000
000000000000
000000000000
000000000000
00000000000X
000000000000
000000000000
00X00000X000
000000000000
000000000000
0000X000X000
000000000000
000000000000
000000000000
000000000000
0000000X0000
000000000000
0X0000000LLL
00000X000LLL
000000000LLL
