000000000000
0000X0X00000
000000000000
000000000000
000000000000
000000000000
000000000000
000000000000
000000000000
000000000000
000000000000
000000000000
00000X0XX000
000000000000
000000000000
000000000000
00000X000000
00XX00000000
000000000LLL
000000000LLL
000000000LLL
