0000000X0000
000000000000
000000000000
000000000000
000000000000
0000XX000000
000000000000
000000000000
000000000000
000000000000
000000000000
00000000XX00
000000000000
0X0000000000
000000000000
00000000X000
0000000X0000
0X0000000000
000000000LLL
000000000LLL
000000X00LLL
