000000000000
0000000000X0
000X00000000
000000000000
0000X0000000
000000000000
000000000000
000000000000
000000000000
000000000000
000000000000
000000X00000
00000000000X
X0X000000000
00X000000000
000000000000
000000000000
000000000000
000000000LLL
000000000LLL
000000000LLL
