000000000000
000000000000
000000000000
000000000000
000000000000
000000000000
000000X00000
000000000000
00X000000000
000000000000
00X000000000
000000X00000
000000000000
000000000000
000000000000
00X000000000
0X0000000000
000000000000
00000X000LLL
0000000X0LLL
000X00000LLL
