0000000XX000
000000000000
000000000X00
000000000000
0000X0000000
000000000000
0X0000000000
00X000000000
000000000000
00000000000X
000000000000
000000000000
000000000000
000000000000
000000000000
000000000000
000000000000
000000000000
000000000LLL
000000000LLL
0X0000000LLL
