000000000000
000000000000
000000000000
000000000000
000000000000
000000000000
000000000000
000000000000
000000000000
000000000000
00000X000000
000000000000
000000000000
0000000X0X00
0000X0000000
0X0X0000000X
000000000000
X00000000000
00X000000LLL
X00000000LLL
000000000LLL
