000000000000
00000000X0X0
00000000000X
000X00000000
000000000000
X00000000000
000000000000
00000000000X
000000000000
000000000000
000000000000
00X00000000X
0X0000000000
000000000000
000000000000
000000000000
00000000X000
000000000000
000000000LLL
000000000LLL
000000000LLL
