000000000000
000000000000
0000X0000000
000000XX0000
000000000000
000000000000
0000000X0000
0000X00X0000
0000X0000000
000000000000
000000000000
000000000000
000000000000
000000000000
00000X000000
000000000000
0000X00000X0
000000000000
000000000LLL
000000000LLL
000000000LLL
