000000000000
000000000000
000000000000
0000000XX000
000X00000000
000000000000
000000000000
000000000000
000000000000
000000000000
000000000000
000000000000
000X0X000000
000000000000
X00000000000
000000000000
X00000000000
000X00000000
00000000XLLL
000000000LLL
000000000LLL
