000000000000
000000X00000
000000000000
000000000000
00000000000X
00000000000X
000000000000
000000000000
00X0000000X0
0000000X00X0
00X000000000
000000000000
000000000000
0000X0000000
000000X00000
000000000000
000000000000
000000000000
000000000LLL
000000000LLL
000000000LLL
