00000000X000
000000000000
0X0000000000
00000000000X
000X00000000
000000000000
000000000000
000000000000
000000000000
000000000000
000000000000
000000000000
000000000000
00000000X000
000X00000000
000000000000
000000000000
000000000000
00X0000X0LLL
000X00000LLL
000X00000LLL
