0000000X000X
00000X000000
000000000000
000000000000
000000000000
000000000000
000000000000
0X0000000000
000000000000
000000000000
000000000000
000000000000
0000000X0000
000000000000
000000000000
000000000000
X00000000X00
00000000000X
0X0000000LLL
000X00000LLL
000000000LLL
