000X00000000
X00000000000
000000000000
00000X000000
000000000000
000000000000
000000000000
00X0000000X0
000X00000000
000000000000
000000000000
0000000X0000
000000000000
000000000000
000000000000
000000000000
000000000X00
0000X0000000
000000000LLL
0000000X0LLL
000000000LLL
