000000000000
000000000000
000000000000
000000000000
0000000X0000
0X0000000000
000000000000
00XX00000000
000000000000
00000X000000
00X0000X0000
000000000000
000000000000
00000000X000
000000000000
000000000000
000000000000
000000000000
0000000X0LLL
000000000LLL
000X00000LLL
