000000000000
00000000X000
000000000000
00000000XX00
000000000000
000000000000
000000000000
000000000000
000000000000
0X0000000000
000000X00000
000000000000
000000000000
000000000000
X00000000000
000000000000
000000000X00
000000000000
X00000000LLL
0X0000000LLL
000000000LLL
