000000000000
000000X00000
0000XX000000
000000000000
000000000000
000000000000
0000000000X0
00000000X000
000000000000
0000000X0000
000000000000
000000000000
000000000000
000000000000
000000000000
000000X000X0
00000X000000
000000000000
0000000X0LLL
000000000LLL
000000000LLL
