000000000000
000000000X00
000000000000
000X00000000
000000X00X00
0000X0000000
000000X00000
0X0000000000
000000000000
000000000000
000000000000
000000000000
000000000000
000000000000
000000000000
000000000000
000000000000
000000000000
000000000LLL
X00000000LLL
000000000LLL
