00000000000X
000000000000
000000000000
0000000X0000
000000000000
000000000000
000000000000
000000000000
000000000000
0000000X0000
000000000000
000000000000
000000000000
000000X00000
000000000X00
000000000000
000000000000
000000000000
000000000LLL
0000X00X0LLL
00X00X000LLL
