00000000000X
0X0000000000
000000000000
000000000000
000000000000
000000000000
000000000000
000000000000
000000000000
0X00000000X0
000000000000
000000000000
000000000000
00000X000000
00X000000000
X00000000000
000000000000
000000X00000
000X00000LLL
00X000000LLL
000000000LLL
