000000000000
000X00000000
0000X0000000
000000000000
000000000000
000000000000
000000000000
0000X00X0000
000000000000
000000000000
0000000000X0
00000000000X
0000000X0000
000000000000
X00000000000
0000000000X0
0000000X0000
000000000000
000000000LLL
000000000LLL
000000000LLL
