000000000000
000000000000
000000000000
000000000000
00000000000X
000000000000
0000000X00X0
000000000000
00000000000X
000000000000
000000000000
000000000000
0000X0000000
00X000000000
000000000000
000000000000
000000X0000X
000000000000
000X00000LLL
000000000LLL
000000000LLL
