000000000000
0000X0000000
000000000000
000000000000
000000000000
000000000000
000000000000
000000X00000
000000000000
000000000000
00000XX00000
0000X0000000
000000000000
000000000000
000000000000
000000000X00
000000000000
0000000000X0
000000000LLL
000X00000LLL
0000000X0LLL
