000000000000
000000000000
00000000X000
000000000000
0X0000000000
000000000000
X0000XX00000
000000000000
000000000X00
000X00000000
000000000000
00000X0000X0
000000000000
00X000000000
000000000000
000000000000
000000000000
000000000000
000000000LLL
000000000LLL
000000000LLL
