0000X0000000
000000000000
000000000000
000000000000
00000X0X0000
000000000000
000X00000000
000000000000
000000000000
000000000000
00X000000000
00000000000X
000000000000
00000X0000X0
00000000000X
000000000000
000000000000
000000000000
0000X0000LLL
000000000LLL
000000000LLL
