000000000000
000000000000
000000000000
000000000000
000000000000
X00000000X00
0000000X0X00
000000000000
000000000000
00000000000X
000000000000
000000000000
000000000000
000X00000000
000000000000
000000000000
000000000000
000000000000
00000X00XLLL
000000000LLL
000000000LLL
