X000X0000000
000000000000
000000000000
000000000000
00X0000X0000
0000000X0000
000000000000
000000000000
0X0000000000
000000000000
000000000000
000000000000
000000000000
000000000000
000000000X00
000000000000
000000000X00
00000000000X
0000000X0LLL
000000000LLL
000000000LLL
