000000000000
000000000000
0000X0000000
00000X000000
000000000000
000000000000
00000X000000
000000000000
000000000000
000000000000
000000000000
000000000000
00000000000X
X00000000000
000000X00000
0000000000X0
00000000X000
00X000000000
000000000LLL
000000000LLL
000000X00LLL
