000000000000
0X0000000000
000000000000
000000000000
000000000000
0000000X0000
000000000000
000000000000
0000000000X0
000000000000
000000000000
X0000000X000
000000000000
000000000000
X0X00000000X
000000000000
000000000000
00X00000X000
000000000LLL
000000000LLL
000000000LLL
