000000000X00
00000000000X
000000000000
0X00X0000000
000000000000
000000000000
000000000000
000000X00000
000000000000
000000000000
000000000000
000000X00000
000000000000
000000000000
0X0000000000
00X000000000
000000000000
000000000000
000000000LLL
000000000LLL
0000000X0LLL
