000000000000
000000000000
00000X000000
00X000000000
00X000000X00
X0X000000000
000000000000
000000000000
000000000000
000000000000
000000000000
000000000000
0000000000X0
000000000000
000000000000
000000000000
000000000000
000000000000
000000000LLL
000000XX0LLL
000000000LLL
