000000000000
000000000000
000000000000
00000000X000
000000000000
000000000000
000000000000
00000000X000
0X0000000000
000000000000
000000000000
00000000X000
00000000000X
000000000000
000000000000
0X0000000000
00000000000X
000000000000
000X00000LLL
00000000XLLL
000000000LLL
