000X00000000
000000000000
00000000X000
000X00000X00
000000000000
00X0000000XX
000000000000
000000X00000
0000000X0000
000000000000
000000000000
000000000000
000000000000
000000000000
000000000000
000000000000
000000000000
000000000000
00X000000LLL
000000000LLL
000000000LLL
