000X00000000
000000000000
000000000000
000X00000000
000000000000
0000000X00X0
00X000000000
000000000000
000000000000
000X00000000
000X00000000
000000000000
000000000000
000000000000
000000000000
000000000000
00000000X000
0XX000000000
000000000LLL
000000000LLL
000000000LLL
