000000000000
0X0000000000
000000000000
000X00000000
000000000000
000000000000
000000000000
000X000X0000
00000000000X
000000000000
000000000000
0X0000000000
000000000000
000000000000
000XX0000000
00000000X000
000000000000
000000000000
00X000000LLL
000000000LLL
000000000LLL
