000000000000
000000000000
000000000000
000000000000
000000000000
X00000000000
000000000000
000000000000
000000000000
000000000000
00X000000000
000000000X00
0000000X000X
0000X0000000
000X0000X000
000000000000
000000000000
000000000000
000000000LLL
000000000LLL
0000X00X0LLL
