000000000000
00000X000000
000000000000
000000000000
000000000X00
X00000000000
0000000X0000
000000000000
000000000000
00000X000000
000000000000
000000000000
0000000X0000
000000000000
000000000000
00000000X000
00000000000X
000000000000
00000000XLLL
00000X000LLL
000000000LLL
