X00000000000
00X0X000X00X
000000000000
000000000000
0000000X0000
000000000000
000000000000
000000000000
000000000000
000000000000
000000000000
000000000X00
00000X000000
000000000000
000000000000
00000XX00000
000000000000
000000000000
000000000LLL
000000000LLL
000000000LLL
