000000000000
0X0000000000
000000000000
000000000000
X00000000000
00000X000000
000000000000
000X00000000
000000000000
000000000000
0000000000XX
0X0000000000
000000000000
000000000000
00000X0000X0
000000000000
000X00000000
000000000000
000000000LLL
000000000LLL
000000000LLL
