000000000X0X
000000000000
000000000000
000000000000
000000000000
000000000000
000000000000
000000000000
000000000000
000000000000
000000000000
000000X00000
000000X0000X
000000000000
000000000000
0000X0000000
00000X000000
000000000000
000000X00LLL
000000X00LLL
000000000LLL
