000000000000
000000000000
X00000000000
00000X000000
000000000000
00000000000X
00000000X000
000000000000
000000X00000
000000000000
000000000000
000000000000
000000000000
00X000000000
X00000X00000
000000000000
000000000000
000000000000
000000000LLL
000000000LLL
00000000XLLL
