000000000000
000000X00000
000000000000
000000000000
000000000000
000000000000
000000000000
000000000000
0000000000X0
X00000000000
000000000000
000000000000
000000000000
X00000000X00
000000000000
000000000000
000000000000
000000X000X0
000000000LLL
000000000LLL
0000XX000LLL
