000000000000
000000000000
000000000000
000000000000
000000000000
00000000X00X
000000000000
00X0XX000X00
000000000000
000000000000
000000000000
000000000000
000000000000
000000000000
000000000000
0X0000X00000
000XX0000000
000000000000
000000000LLL
000000000LLL
000000000LLL
