0000000X0000
000000000000
000000000000
000000000000
000000000000
000000000000
000000000000
000000000000
000000000000
00000X000X00
000X00000000
000000000000
000000000000
000000000000
000000000000
0X0000000000
0X0000000000
X00000XX0000
X00000000LLL
000000000LLL
000000000LLL
