00000000000X
000000000000
00X000000000
00X00000X000
0000000000X0
000000000000
000000000000
0X0000000000
0X0000000000
00000000000X
000000000000
000000000000
000000000000
000000000000
000000X00000
000000000000
000000000000
00000X000000
000000000LLL
000000000LLL
000000000LLL
