000000000000
000000000000
000000000000
000000000X00
00X00000000X
000000000000
0000X0000000
000000000000
000000000000
000000000000
000000000000
000X00000000
000000000000
000000000000
000000000000
000000000000
000000000000
000000000000
0X0000000LLL
00000XX00LLL
000000000LLL
