00000X000000
000000000000
000000000000
000000000000
000000000000
000000000000
000000000000
000000000X00
00000X0X0000
000000000000
0X0000000000
0000000XX000
000000000000
000000000000
000000000X00
000000000000
X00000000000
000000000000
000000000LLL
000000000LLL
000000000LLL
