000000000000
000000000000
000000000000
000X00000X00
000000000000
000000000000
000000000000
00000XX00000
0000000X0000
000000000000
000000000000
000000000000
000000000000
000000XX0000
00X000000000
000000000000
000000000000
000000000000
X00000000LLL
00000000XLLL
000000000LLL
