000000000000
000000000000
000000000000
0X00000000X0
000000000000
000000000000
000000000000
000000000000
00000000000X
000000000000
000000000000
00000000000X
000000000000
000000000000
000000000000
0000000X00X0
0000X0000X00
000000000000
X00000000LLL
X00000000LLL
000000000LLL
