00000000X000
000000000000
000000000000
000000000000
X00000X00000
00X000000000
000000000000
000000000000
000000000000
000000000000
00000X000000
000000000000
000000000000
000000000000
0000X0000000
000000000000
000000000000
000X00000000
000000000LLL
00000000XLLL
0000X00X0LLL
