X00X0000X000
00000000000X
000000000000
000000000000
000000000000
00000X000000
000000000000
000000000000
000000000000
000000000000
000000000000
0000XXX00000
000000000000
000000000000
000000000000
000000000000
000000000000
000000000000
000000000LLL
000000000LLL
00X000X00LLL
