000000000000
0000000000X0
000000000000
00X000000000
000000000000
000000000000
000000000000
000000000000
00X00000X000
000000000000
00000X000000
000000000000
000000000000
00X000000000
000000000000
XX0000000000
000000000000
0000000000X0
000000000LLL
0000000X0LLL
000000000LLL
