000000000000
000000000000
000000000000
000000000X00
000000000000
000X00000000
0X00000000X0
000000000000
X00000000000
000000000000
00X000000000
0X0000000000
00000000000X
000000000000
000X00X00000
000000000000
000000000000
000000000000
000000000LLL
000000000LLL
000000000LLL
