000000000000
000000000X00
000000000000
000000000000
000000000X0X
00000000X000
000000000000
000000000000
000000000000
000000000000
000000000000
000000000000
00000000X000
000000000000
00000000X000
000X00000000
0X0000000000
000000000000
000000000LLL
000000000LLL
0000000X0LLL
