0XX000000000
000000000000
000000000000
000000000000
000000000000
000000000000
000000000000
000000000000
000000000000
0X0000X00000
000000000000
000000000000
0X000000X000
000000000000
000X00000000
000000000000
00X000000000
000000000000
000000000LLL
000000000LLL
000000000LLL
