00X000000000
000000000000
000000000000
000000000000
000000000000
0000000000X0
0000000X000X
000000000000
000000X00000
000000000000
00X000000000
000X00000000
000000000000
000000X00000
000000000000
000000000000
000000000000
000000000000
00000X000LLL
0X0000000LLL
000000000LLL
