000000000000
000000000000
000000000000
00XX0X000000
000000000000
000000000000
000000000000
0000000X0000
000000000000
000000000000
000X00000000
0000000X0000
000000000000
0X0000000000
000000000X00
000000000000
000000000000
0000X0000000
000000000LLL
000000000LLL
000X00000LLL
