000000000000
000000000000
000000X00000
000000000000
000000000000
000000000000
000000000000
000000000X00
000000000000
00X000000000
000X00X00X00
000000000000
00000000X000
000000000000
000000000000
000000000000
00X000X00000
000000000000
000000000LLL
000000000LLL
000000000LLL
