000000000000
000000000000
000000000000
000000000000
000000000000
000000000X00
000000000000
000000000000
000000000000
000000000000
000000000000
0000000X0000
000000000X0X
000000000000
000000000000
0000X0000000
000000000000
00000000X000
0X0000000LLL
0X0X00000LLL
X00000000LLL
