000000000000
00X00000X000
00X000000000
000000000000
000000000000
00000000X000
000000000000
00X000000000
000000000000
0X0000000000
000000000000
000000000000
0000000X0000
000000000X00
00000000X000
000000000000
000000000000
000000000000
000000000LLL
000000000LLL
X00000000LLL
