000000000X00
000000000000
0X00XX000000
0000000X0000
000000000000
000000000000
000000000000
000000000000
000000000000
000000000000
00X00000000X
00X000000000
X00000000000
000000000000
000000000000
000000000000
0X0000000000
000000000000
000000000LLL
000000000LLL
000000000LLL
