000000000000
00000000000X
00000X000000
00XX00000000
000000X00000
000000000000
000000000000
000000000000
000000000000
000000000000
X00000000000
000000000000
000000000000
00000000000X
000000000000
000000000000
000000000000
00000000000X
X00000000LLL
000000000LLL
000000000LLL
