000000000000
000000000000
000000000000
000000000000
000000000000
000000000000
000000000000
00X00000000X
000000000000
000X00000000
000000000000
X00000000000
000000000000
0000000X0000
000000000000
000000000000
0000X0000000
000000XX0000
000000000LLL
000000000LLL
000000000LLL
