X000X0000000
000000000000
0000000X0000
000000000000
X00000000000
000000000000
0000X0000000
0X0000000000
000000000000
000000000000
000000000000
000000X00000
000000000000
000000000000
000000000000
000000000000
000000000000
0X0000000000
000000000LLL
000000000LLL
000X00000LLL
