000000000000
000000000000
000000000000
000000000000
000000000000
0000000X0000
000X00000000
00X000000000
000000000000
000000000000
00X0000X0000
000000000000
000000000000
000000000000
0000000X0000
000000000000
000X00000000
000000000000
000XX0000LLL
000000000LLL
000000000LLL
