0000X0000000
000000000000
000000000000
000X00000000
00000000000X
000000000000
000X00000000
000000000000
00000X000000
X00000000000
000000X00000
000000000000
000000000000
00X000000000
000000000000
000000000000
000000000000
000000000000
000000000LLL
000000X00LLL
000000000LLL
