000000000000
000000000000
000000000000
000000000000
000000000000
0000000X0000
0X000000X000
000000000000
000X00000000
000000000000
000000000000
00000X000000
000000000000
000X00000000
000000000000
000000000000
000000000000
000000000000
0X0000000LLL
000000X0XLLL
000000000LLL
