0000000X0000
000000000000
00000000X000
000000000000
00000000X000
000000000000
000000000000
0X0000000000
000000000X00
000000000000
000000000000
000000000000
000000000000
000000000000
000000000000
00000000X0X0
0000000000X0
000000000000
000000000LLL
000000000LLL
000000000LLL
