000X00000000
000000000000
0000X0000000
000000000000
000000000000
00000X000X00
000000000000
X00000000000
000000000000
000000000000
0000000000XX
000000000000
000000000000
000000000000
000000000000
000000000000
00000X000000
000000000000
000000000LLL
000000000LLL
00000000XLLL
