0000X0000000
00000000000X
000000000000
000000000000
000000000000
00000000X000
000000000000
0000X0000000
00000000X000
00X000000000
000000000000
000000000000
000000000000
0000X00000X0
000000X00000
000000000000
000000000000
000000000000
000000000LLL
000000000LLL
000000X00LLL
