00000000000X
000000000000
000000000000
000000000000
000000000000
0X0000000000
000000000000
000000000000
X0000000X000
00X00X0000X0
000000000000
000000000000
000000000000
00000000000X
000000000000
0X0000000000
000000000000
000000000000
000000000LLL
000000000LLL
000000000LLL
