000000000000
000000000000
000000000000
0000000X0000
000000000000
000X00000X00
000000X0X000
000000000000
000000000000
000000000000
00000X000000
000000X00000
0000000X00X0
000000000000
0000000X0000
000000000000
000000000000
000000000000
000000000LLL
000000000LLL
000000000LLL
