00000000000X
000000000000
00000X000000
000000000000
000000000000
000000000000
00000X000000
000000000000
00X000000000
000000000000
00000X000000
0000000X0000
000000000000
000000000000
000000000000
XX0X00000000
000000000000
000000000000
000000000LLL
0X0000000LLL
000000000LLL
