000000000000
000000000000
00X000000000
X00000X00000
000000000000
000000000000
0X00000000X0
000000000000
00X000000000
000000000000
000000000000
000000000000
000000000000
000000000000
00000000000X
000000000000
000000000000
00000000X000
000000000LLL
000000000LLL
X00000000LLL
