000000000000
0000000X0000
000000000000
000000000X00
000000000000
000000000000
000000000000
000000000000
X000X0000000
X00000000000
000000000000
000000000X00
000000000000
000000000000
000000000000
X00000000000
00000X000000
000000000000
000X00000LLL
000000000LLL
000000X00LLL
