000000000000
0000000XX0X0
0X0000000000
000000000000
000000000000
000000000X00
000000000000
0000X0000000
000000000000
000000000000
000000000000
00X00X000000
000000000X00
000000000000
0000000X0000
000000000000
000000000000
000000000000
000000000LLL
000000000LLL
000000000LLL
