00000000000X
X00000000000
000000000000
000X00000000
000000000000
000000000000
000000000000
000000000000
0X0000000000
000000000000
000X00000000
0000000XX000
00000000XX00
000000000000
000000000000
0000000X0000
000000000000
000000000000
000000000LLL
000000000LLL
000000000LLL
