000000000000
0X0000000000
0X0000000000
000000000000
000000000000
000000000000
000XX0000000
000000000000
000000000000
0X0000X00000
000000000000
000000000000
000000000000
000000000000
000X00000000
000000000000
00000000000X
000000000000
00X0X0000LLL
000000000LLL
000000000LLL
