0000000000X0
000X00000000
000000000000
000X00000000
000000000000
00000000X000
000000000000
000000000000
000000000000
000000000000
0000000000X0
000000000000
00000000X000
000000000000
000X000X0000
00000000000X
000000000000
000000000000
000000000LLL
000000X00LLL
000000000LLL
