0000X0000000
000000000000
000000000000
000000000000
000000000000
000000000000
0000X0000000
0000000X0000
00000X000000
000000000000
0000X000000X
00000X000000
00000000X000
000000000000
000000000000
000X00000000
000000000000
000000000000
000000000LLL
00X000000LLL
000000000LLL
