000000000000
000000000000
000000000000
000000000000
000000000000
000000000000
0X0000000000
000000000000
0000X00X0000
000000000000
000000000000
000000000000
0X0000000000
000X0X000000
0000000X0000
000000000000
000000000000
0X00X0000000
000000000LLL
000000000LLL
X00000000LLL
