000000000000
00000000X000
000000000000
000000000000
000000000000
000000000000
000000000000
000000000000
000000000000
00000X0000X0
000000000000
0000000000X0
0X00000X0000
000000000000
X00000000000
00000000000X
000000000000
000000000000
000000000LLL
000000X00LLL
0000000X0LLL
