0000000X0000
0000000000X0
00X000000000
000XX0000000
000000000000
000000000000
000000000000
000000000000
000000000000
000000000000
0XX000000000
000000000000
000000000000
000000000000
000000000000
000000000X00
0000000000X0
000000000000
000000000LLL
000000000LLL
0X0000000LLL
