000000000000
0000X0000000
0000X0000000
000000000000
X00000000000
000000000000
000000000000
000000000000
00X000000000
000000000000
000000X00000
000000000000
000X00000000
000000000000
000000X00000
000000000000
000000000000
000000000000
X00000000LLL
000000000LLL
00X000000LLL
