000000000000
000000000000
00000000000X
000000000000
000000000000
X00000000000
000000000X00
000000000000
000000000000
X0000000000X
000000000000
000000000000
000X00000000
000000000X00
000000000X00
000000000000
000000000000
000000000000
000000000LLL
000000000LLL
0000X000XLLL
