000000000000
000000000000
000000000000
000000000000
000000000000
000000000000
000000000000
000000000000
000000000000
00000X000000
000000000000
0X0000000000
00000000X000
00000X0000X0
0000000X0000
0000000X0000
0000X0000000
000000000000
000000000LLL
000000000LLL
0X00X0000LLL
