X00000000000
000000000000
000000000000
000000000000
000000000000
000000000000
00000000000X
000000000000
000000000000
000000000000
00000000000X
0X0000000000
000000000000
000000000000
000000000000
000000000000
0000000X0000
000XX0000000
000000X00LLL
000000000LLL
X00000000LLL
