#######################
#OOXXOOOOOOOOOOOOOOOOO#
#OOXXOOOOOOOOOOOOOOOOO#
#OOOOOOOOOOOOOOOOOOOOO#
#OOOOOOOOOOOOOOOOOOOOO#
#OOOOOOOOOOOOOOOOOOOOO#
#OOOOOOOOOOOOOOOOOOOOO#
#OOOOOOOOOOOOOOOOOOOOO#
#OOOOOOOOOOOOOOOOOOOOO#
#OOOOOOOOOOOOOOOOOOOOO#
#OOOOOOOOOOOOOOOOOOOOO#
#OOOOOOOOOOOOOOOOOOLLL#
#OOOOOOOOOOOOOOOOOOLLL#
#OOOOOOOOOOOOOOOOOOOOO#
#OOOOOOOOOOOOOOOOOOOOO#
#OOOOOOOOOOOOOOOOOOOOO#
#OOOOOOOOOOOOOOOOOOOOO#
#OOOOOOOOOOOOOOOOOOOOO#
#OOOOOOOOOOOOOOOOOOOOO#
#OOOOOOOOOOOOOOOOOOOOO#
#OOOOOOOOOOOOOOOOOOOOO#
#OOOOOOOOOOOOOOOOOOOOO#
#######################
#######################
#######################
#######################
#######################
#######################
#######################
#######################
#######################
#######################
#######################
#######################
#######################
#######################
#######################
#######################
#######################
#######################
#######################
#######################