000000000000
000000000000
000X0XX00000
000X00000000
000000000000
000000000000
000000000000
000000000000
00000000X000
000000000000
000000000000
000000000000
00000000X000
000000000000
00X000000000
000000000000
000000000000
00000000X000
0X0000000LLL
00000X000LLL
000000000LLL
