000000000000
0000X0000X00
00000000X000
000000000000
000000000000
000000000000
000000000000
000000000000
000000000000
00000000X000
X00000000000
000000000000
00000000000X
000000000000
00000000X000
000000000000
000000000000
0000000X0000
00X000000LLL
000000000LLL
000000000LLL
