000000000000
000000000000
000000000000
000000000000
00000X000000
000000000000
X00000000000
000000000000
00000X000000
000000000000
X0X0000000X0
000000000000
000000000000
000000000000
000000000000
000000000000
000000X00000
000X00X00000
000000000LLL
000000000LLL
000000000LLL
