000000000000
X0000000X000
000000000000
000000000000
000000000000
000000000000
000000000000
000000000000
000000000000
000000000000
000000000000
0000000X0000
00X00X000000
00000000000X
000000000000
0X0000000000
00X000000000
000000000000
00000000XLLL
000000000LLL
000000X00LLL
