000X0000X00X
000000000000
0000X0000000
000000000000
000000000000
000000000000
000000000000
000000000000
000000000000
000000000000
000000000000
000000000000
0000X0000000
000000000000
000000000000
000000000000
000000000000
0X000X000000
000000000LLL
000000000LLL
00X0000X0LLL
