000000000000
000000000000
00000X000000
X00X000X0000
00X000000000
000000000000
000000000000
000000000000
000000000000
000000X00000
000000000000
000000000000
000000000000
000X00000000
000000000000
000000000000
X00000000X00
000000000000
000000000LLL
X00000000LLL
000000000LLL
