000000000000
000000000000
000000000X00
000000000000
000000000000
000000000000
000000000000
000000000000
0000X0000000
000000000000
00000000000X
0000000X0000
000000000000
000000000000
X00000000X00
000000000000
000000000000
000000000000
0X0000000LLL
000000X00LLL
0X0000X00LLL
