000000000000
000000000000
000000000000
000000000000
X00000000000
000000000000
00000000000X
000000000000
00X000000X00
0X0000000000
000000X00000
000000000000
X00000000X00
000000000000
000000000000
000000000000
000000000000
0X0000000000
000000X00LLL
000000000LLL
000000000LLL
