000000000X00
000000000000
000000000000
000000000000
000000000000
000000000000
00X000000000
000000000000
0000000X0000
0000000X0000
000000000000
000000000000
000000000000
000000000000
00000X0X0000
000X00000000
000000000X00
000000000000
000000000LLL
0000X0000LLL
000000000LLL
