########################
#OOXXOOOOOOOOOOOOOOOOOO#
#OOXXOOOOOOOOOOOOOOOOOO#
#OOOOOOOOOOOOOOOOOOOOOO#
#OOOOOOOOOOOOOOOOOOOOOO#
#OOOOOOOOOOOOOOOOOOOOOO#
#OOOOOOOOOOOOOOOOOOOOOO#
#OOOOOOOOOOOOOOOOOOOOOO#
#OOOOOOOOOOOOOOOOOOOOOO#
#OOOOOOOOOOOOOOOOOOOOOO#
#OOOOOOOOOOOOOOOOOOOOOO#
#OOOOOOOOOOOOOOOOOOOLLL#
#OOOOOOOOOOOOOOOOOOOLLL#
#OOOOOOOOOOOOOOOOOOOOOO#
#OOOOOOOOOOOOOOOOOOOOOO#
#OOOOOOOOOOOOOOOOOOOOOO#
#OOOOOOOOOOOOOOOOOOOOOO#
#OOOOOOOOOOOOOOOOOOOOOO#
#OOOOOOOOOOOOOOOOOOOOOO#
#OOOOOOOOOOOOOOOOOOOOOO#
#OOOOOOOOOOOOOOOOOOOOOO#
#OOOOOOOOOOOOOOOOOOOOOO#
########################
########################
########################
########################
########################
########################
########################
########################
########################
########################
########################
########################
########################
########################
########################
########################
########################
########################
########################
