000000000000
000000000000
000000000000
000000000000
000000000000
000000000000
000000X00000
0000X0000000
000000000000
000000000000
000000000000
000000000000
000000000000
0X0000000000
0000X000X000
0X0000000000
000000000000
0000000X0000
0000000X0LLL
00X000000LLL
000X00000LLL
