000000000000
000000000000
000000000000
000000000000
000000000X00
00X000000000
000000000000
0X0000000000
00000X000000
000000000000
000000000000
000000000000
000000000000
000000000000
000000000000
00X000000000
000000000000
00X0X0000000
0X0000000LLL
0000000X0LLL
000000X00LLL
