000000000000
000000000000
000000000000
000000000000
000000000000
000000000000
X00000000000
000000000000
000000000X00
000000000000
00X000000000
00X000000000
000X00000000
000000000000
000X00000000
000000000000
00X0000X0000
000000000000
00X0X0000LLL
000000000LLL
000000000LLL
