0000X0000000
000000000000
000000000000
00000000000X
000000000000
000000000000
000000000000
X00000000000
000000000000
0000000000X0
000000000000
000000000000
X00000000000
000000000000
000000000000
0X0000000000
0000X0000000
000000X0X000
000000000LLL
000000000LLL
000000000LLL
