000000X00000
000000000000
000000000000
000000000000
0000000000X0
0000000X0000
000000000000
000000000000
00000000XX00
000000000000
000000X00000
000000000000
000000000000
000000000000
000000000000
0000000000X0
00X000000000
00X000000000
000000000LLL
X00000000LLL
000000000LLL
