000000000000
000000000000
000000000000
000000000000
000000000X00
000000000000
000000000000
000000000000
000X00000000
000000000000
000000000X00
00000000000X
000000000000
00000000000X
00X00X000000
00X000000000
000000000000
000000000000
000000000LLL
X00000000LLL
000000000LLL
