000000000000
0000X0000000
000000000000
000000000000
0000X0000X00
000000000000
000000000000
00000000000X
00X000000000
000000000000
000000000000
00XX0X000000
0X0000000000
000000000000
000000000000
000000000000
000000000000
000000000000
000X00000LLL
000000000LLL
000000000LLL
