000000000000
000000000000
000XX0000000
00X000000000
000000X00000
000000000000
00000000000X
000000000000
000000000000
000000000000
000000000000
000000000000
000000000000
000000000000
0000000X0000
000X00000000
000000000000
0000000X0000
00000XX00LLL
000000000LLL
000000000LLL
