0X00000000X0
000000000000
000000X00000
000000000000
000000000000
000000000000
000X00000000
000000000000
000000000X00
000000000000
000000000000
000000000000
00000000000X
000000000000
0000X0000000
00X000000000
000000000000
000000000000
000X00000LLL
000X00000LLL
000000000LLL
