000000000X00
000000000000
X00000000000
X00000000000
000000000000
0000X0000000
000000000000
000000000000
000000000000
000000000000
00X000000000
000000000000
000000000000
000000000000
0000X0000000
00000000000X
X00000X00000
000000000000
000000000LLL
000000000LLL
000000000LLL
