000000000000
000000000000
000000000000
0X0000000000
000000000000
000000000000
000000000000
000000000000
000000000000
00000000000X
000000000000
0000000000X0
0000X0000000
000XX0000000
000000000000
000000000000
000000000000
00000000000X
0000X0000LLL
000000000LLL
000000000LLL
