0000000X0000
0000000000X0
X0000000X000
000000000000
000000000000
000000000000
000000000000
000000000000
000000000000
000000000000
00X000000000
00000XX00000
000000000000
00000000X000
000000000000
000000000000
000000000000
000000000000
000000000LLL
000000000LLL
000X00000LLL
