000000000000
000000000000
00000000000X
000000000000
000000000000
0000XX000000
000000000000
000X00000000
0000X0000000
000000000000
0000000000X0
000000000000
000000X00000
000000000000
0000000000X0
X00000000000
000000000000
000000000000
000000000LLL
000000000LLL
X00000000LLL
