000000000000
0000000X0000
0000000X0000
000000000000
X00000000000
000000000000
0000000000X0
0000000X0000
000000000000
000000000000
00000X000000
0X0000000000
000000000000
000000000000
X00000000000
00X000000000
000000000000
000000000X00
000000000LLL
000000000LLL
000000000LLL
