000000000000
0000000000X0
000000000000
000000000000
000000000000
000000000000
0X0000000000
X00000000000
0X0000000000
000000000000
000000000000
000000000000
00000000000X
000000000000
00000000X000
000000000000
000000X00000
000000000000
000000000LLL
00000000XLLL
000000X00LLL
