000000000000
00X0000X0000
0X00000000X0
000X00000000
000000000000
000000000000
000000000000
000000000000
000000000000
000000000000
00000000X000
000000000000
000000000000
000000000000
000000000000
X00000000000
X00000000000
000000000000
000000000LLL
000000000LLL
00000000XLLL
