0000X00000X0
00X0000000X0
00000000X000
000000000000
000000000000
000000000000
000000000000
000000000000
000000000000
000000000000
000000000000
000000000000
000000000000
000000000000
000000000000
000000X00000
000000000000
000000000000
00000000XLLL
0000000X0LLL
00000000XLLL
