0000X0000000
000000000000
000000000000
000XX0000000
00000000000X
000000000000
000000000000
000000000000
000000000000
000000000000
000000X00000
000000X00000
00000000X000
000000000000
000000000000
000000000X00
000000000000
000000000000
000X00000LLL
000000000LLL
000000000LLL
