000000X00000
0000X0000000
000000000000
0000000000X0
000000000000
0000000000X0
0X0000000000
000000000000
000000000000
00000000X000
000000000000
000X00000000
000000000000
000000000000
000000000000
000000000000
X00000000000
000000000000
0000X0000LLL
000000000LLL
0X0000000LLL
