000000000000
000000000000
000000000000
000000000000
000000000000
000000000X00
X00000000000
000000000000
00000000X000
0000X0000000
000000000000
000000000000
000000X00000
000000000000
000X00000000
0000X0000000
00000X000X00
00000X000000
000000000LLL
000000000LLL
000000000LLL
