000000000000
0X0000000000
00000X000000
000000000000
000000X00000
000000000000
000000000000
000000000000
00000000X000
000000000000
000000000000
000000000000
00XX00000000
000000000000
0000X0000000
00000000X000
000000000000
000X00000000
000000000LLL
000000000LLL
000000000LLL
