000000000000
000000000000
000000000000
000000000X00
000000000000
000000000000
000000000000
000000000000
0000X00000X0
000000000000
0X0000000000
X00000000000
000000000000
000000000000
00000000X000
000000000000
0X0000000000
000000000000
000000000LLL
000000000LLL
00X00000XLLL
