000000000000
0000X0000000
0X0000000000
000000000000
000X00000X00
000000000000
00X000000000
000000000000
000000000000
000000000000
000000000000
000000000000
000000000X00
000000000000
0X0000000000
000000000000
000000000000
X0000000X000
000000000LLL
000000000LLL
000000000LLL
