000000000000
000000000000
000000000000
000000000000
000000000000
000X00X00000
000000000X00
0000X0000000
000000000000
00000X000000
000X00000X00
000000000000
000000000000
00000000000X
000000000000
000X00000000
000000000000
000000000000
00X000000LLL
000000000LLL
000000000LLL
