000000000000
000000000000
000000000000
000000000000
000000000000
000X00000000
0000000X00XX
000000000000
000000000000
000000000X00
0000000X0000
000000000000
0000X00000X0
000000000000
000000000000
000000000000
000000000000
000X00000000
X00000000LLL
000000000LLL
000000000LLL
