000000000000
000000000000
000000000000
000000000000
000000000000
000000000000
000000000000
000000000000
000XX0000000
00X000000000
000000000000
00000X000000
000000000000
000X00000000
0000000000X0
0000X0000000
000000000000
0X00X0000000
000000000LLL
000000000LLL
000000000LLL
