000000000000
000000000000
000000000000
000000000000
000000000000
00X000000000
000X00000000
000000000000
000000000000
000X00000000
000000000000
000000000000
000000000000
000000000000
00X000000000
X00X00000000
00000000XX00
0000X0000000
000000000LLL
X00000000LLL
000000000LLL
