000000000000
000000000000
00000000000X
000000000000
000000000000
000000000000
000000000000
000XX0000000
000000000000
000000000000
0000X0000000
000000000000
000000000000
00000000X000
000000000X00
0000000X000X
000000000000
000000000000
000000000LLL
000000000LLL
0000X0000LLL
