000000000000
000000000000
000000000000
000000000000
000000000000
000000000000
000000000000
000000000000
X00000000000
000000000000
00X000000000
000000000X00
000000000000
000000000000
000000000000
000000000000
000000000000
X0000000000X
0000000X0LLL
0X0000000LLL
0X0000X00LLL
