000000000000
000000000000
000000000000
000000000000
000000000000
000000000000
X0X000X00000
000000000000
000000000000
000X00000000
00000X000000
00X000000000
000000X00000
000000000000
000000000000
000000000000
000000X00000
000000000000
000X00000LLL
000000000LLL
0000000X0LLL
