000000000000
000000000000
000000000000
000000000000
000000000000
0000000X0000
000000000000
000000000000
00X000000000
00000X000000
00000X000000
000000000000
000000000000
000000000000
000000X00000
0000000X000X
000000000000
0000000XX000
000000000LLL
000000000LLL
000000X00LLL
