0000000000X0
0X0000000000
000000000000
00X000000000
000000000000
000000000000
000000000000
0X0000000000
000000000000
000000000000
000000000000
000000000000
000000000000
000000000000
00000X000000
000000000000
0000000X0000
000000000000
000000X00LLL
0X0000000LLL
0000X0X00LLL
