0000000X0000
0X000000000X
000000000000
0X0000000000
0000000000X0
000000000000
000000000X00
000000000000
000000000000
00000000000X
000000000000
000000000000
000000000000
000000X00000
000000000000
000000000000
000000000000
000000000000
0X00X0000LLL
000000000LLL
000000000LLL
