#######################
#OOOOOOOOOOOOOOOOOOOOO#
#OOOOOOOOOOOOOOOOOOOOO#
#OOOOOOOOOOOOOOOOOOOOO#
#OOOOOOOOOOOOOOOOOOOOO#
#OOOOOOOOOOOOOOOOOOOOO#
#OOOOOOOOOOOOOOOOOOOOO#
#OOOOXXOOOOOOOOOOOOOOO#
#OOOOXXOOOOOOOOOOOOOOO#
#OOOOXXOOOOOOOOOOOOOOO#
#OOOOXXOOOOOOOOOOOOOOO#
#OOOOOOOOOOOOOOOOOOLLL#
#OOOOOOOOOOOOOOOOOOLLL#
#OOOOOOOOOOOOOOOOOOOOO#
#OOOOOOOOOOOOOOOOOOOOO#
#OOOOOOOOOOOOOOOOOOOOO#
#OOOOOOOOOOOOOOOOOOOOO#
#OOOOOOOOOOOOOOOOOOOOO#
#OOOOOOOOOOOOOOOOOOOOO#
#OOOOOOOOOOOOOOOOOOOOO#
#OOOOOOOOOOOOOOOOOOOOO#
#OOOOOOOOOOOOOOOOOOOOO#
#######################
#######################
#######################
#######################
#######################
#######################
#######################
#######################
#######################
#######################
#######################
#######################
#######################
#######################
#######################
#######################
#######################
#######################
#######################
#######################
