00X000000000
000000000000
000000000000
0000000000X0
000000000000
000000000000
00000000X000
0000000X0000
X00000000000
00000X000000
000000000000
000000000000
000000000000
000000000000
000000000000
000XX0X00000
000000000000
000000000000
000000000LLL
000000000LLL
0X0000000LLL
