0000X0000000
000000000000
00000000000X
000000000000
000X00000000
0000000X00X0
000000000000
000000000000
000000000000
000000000000
000000X00000
000000000000
00000000X000
0000000000X0
000000000000
00000000X000
000000000000
000000000000
000000000LLL
000000000LLL
000X00000LLL
