000000000000
000000000000
00000X0X0X00
0000000000X0
000000000000
000000000000
00000000X000
000000000000
000000000000
000000000000
00000X000000
000000000000
000000000000
0000000000X0
X00000000000
000000000000
0X0000000000
000000000000
000000000LLL
000000000LLL
000X00000LLL
