000000000000
000000000000
000000000000
0000000X0000
000000000X00
00000X000000
000000000000
0X0000000000
00000000X000
000000000000
000000000000
00000000X000
0000X0X00000
000000000000
000000000000
000000000000
000000000000
000000000000
000000XX0LLL
000000000LLL
000000000LLL
