00000000000X
000000000000
000000000000
000000000000
000000000000
00XX00000000
0000000X0X00
000000000000
0000000000X0
000000000000
000000000000
000X00000000
000000000X00
000X00000000
X00000000000
000000000000
000000000000
000000000000
000000000LLL
000000000LLL
000000000LLL
