000000000000
XX0000000000
000000000X00
00000X00X000
000000000000
000000000000
000000000000
0000000000X0
000000000000
000000000000
00X000000000
0000X00000X0
00X000000000
000000000000
000000000000
000000000000
000000000000
000000000000
000000000LLL
000000000LLL
000000000LLL
