000000000000
000000000000
000000000000
0000000X0X00
000000000000
000000000000
000000000000
000000000000
0000000X0000
00000000X000
00X000000000
0000000000X0
000000000000
00000000X000
000000000000
000000000000
00000X000X00
000000000000
000000000LLL
000000000LLL
0000000X0LLL
