000000000000
000000000000
000000000000
000000000000
000000000000
0000X00000X0
000000000000
000000000000
0X000000X000
0X000000000X
0000000000X0
0000000000X0
000000000000
000000000000
000000000000
00000X000000
000000000000
000000000000
000000000LLL
000000000LLL
000000000LLL
