000000000000
0000000000X0
000000000000
000000000000
000000000000
000000000000
0X0000000000
000000000000
0000000000X0
000000000000
000X0X000000
000000000000
000000000000
00X0000000X0
000000000000
00X000000000
0X0000000000
000000000000
000000000LLL
000000000LLL
000000000LLL
