000000000000
000000000000
000000000000
000000000X00
000X00000000
000000000000
000000000000
000000000000
000000000000
000000000000
00X000000000
000000000000
000000000000
000000000000
000X0X000000
000X00000000
000000000000
00000000000X
000000000LLL
0X0000000LLL
000000000LLL
