000000X00000
0000X0000000
000000000000
000000000000
000000000000
000000000X00
000000000000
0X0000000X00
0000000X0000
000000000000
000000000000
000000000000
000000000000
000000000000
000000000000
000000000000
00X000000000
00000000000X
00X00000XLLL
000000000LLL
000000000LLL
