000000000000
000000000X00
000000000X00
00000X000X00
000000000000
000000000000
000000000000
000000000000
000000000000
0000000X0000
000000000000
000000000000
000X00000000
000000000000
000000000000
000X00000000
000000X00000
0X0000X00000
000000000LLL
000000000LLL
000000000LLL
