0000000X0000
000000000000
000000000000
000000000000
000000000000
00000000X000
X00000000000
000000000000
000000000000
000000000000
000X00000000
000000000000
000000X00000
0000X0000000
000000000000
000000000000
000000000000
00000000X000
000X00000LLL
0000000X0LLL
000000000LLL
