000000000000
00000X000000
00000X000000
00000000X000
0000X0000000
000000000000
000000000000
000000000000
000000000000
000000000000
000000000000
000000000000
000000X00000
000000000000
000000000000
00000000X000
0000XX000000
000000000000
000000000LLL
000000000LLL
00X000000LLL
