00X00000000X
0000000X0000
0X0000000000
0000000000X0
00X000000000
000000000000
00000000000X
000X00000000
000000000000
000000000000
000000000000
000X00000000
000000000000
000000000000
000000000000
000000000000
000000000000
000000000000
000000000LLL
00X000000LLL
000000000LLL
