000000000000
000000000000
00000X000000
X00000X00000
000000000000
000000000000
000000000000
000000000000
000000000000
X00000000000
000000000000
000000000000
0000000X0000
000000000000
00000000X000
00X000000000
000000000000
000000000000
000000000LLL
0000X0000LLL
00X000000LLL
