000000000000
000000000000
000000000000
000000000000
X00000000X00
000000000000
000000000000
000000000000
000000X000X0
000000000000
0000X0000000
000000000000
00000000X000
0000X0000000
000000000000
000000000000
000000000000
00000000000X
00000000XLLL
X00000000LLL
000000000LLL
