000000000X00
000000000000
000000000000
000000000000
000000000000
00000000X000
000000000000
000000000000
000X00000000
000000000000
000000000XX0
000000000000
000000000000
000000X00000
000000000000
000000000000
000000000XX0
0000000X0000
000000000LLL
000000000LLL
00000X000LLL
