00000000000X
000000000000
000000000000
000000000000
00X000000000
000000000000
000000000000
000000000000
000000000000
000000000000
00XXX000000X
000000000000
0000000000X0
000000000000
000000X0000X
000000000000
00000000X000
000000000000
000000000LLL
000000000LLL
000000000LLL
