X00000000000
000000X00000
000000000000
000000000000
00000000X000
00X000000000
0000000X0000
000000000000
000000000000
000000000000
0000X0000000
000000000000
000000000000
000000000000
0000X0000000
000000000000
000000000000
000000000000
000000000LLL
X00000000LLL
0000000X0LLL
