000000X00000
0000000X0000
000000000000
000000000000
000000000000
0000000X0000
000000000000
000000000000
000000000000
000000000000
0000000000X0
0X0000000000
000000000000
000000000000
00000000000X
000X00000000
000000000000
000X00000000
00X000000LLL
000000000LLL
000000000LLL
