000000000000
000000000000
00000000X0X0
000000X0X000
000000000000
000000000000
0000X0X00000
000000000000
000000000000
000000000000
000000000000
000000000000
000000000000
000000000000
000000000000
000000000000
000X00000000
000000000000
000000000LLL
X00000000LLL
00000000XLLL
