0X00000000X0
000000000000
000000000000
000000000000
0000000X0000
0X0000000000
0000000000X0
00X000000000
000000000000
0000000X0000
000000000000
000000000000
000000000000
000000000000
000000X0X000
000000000000
000000000000
000000000000
000000000LLL
000X00000LLL
000000000LLL
