000000X00000
00000X000000
000000000000
0X000X000000
000000000000
000000000000
000000000X00
000000X00000
000000000000
000000000000
000000000000
000000000000
X00000000000
0000000X0000
000000000000
000000000000
00000000X000
X00000000000
000000000LLL
000000000LLL
000000000LLL
