00000000000X
000000000000
00000000000X
000000000000
000000000000
00000X000000
000000000000
X00000000000
000000000000
000000000000
000000000000
000000000000
00000X000000
000000000000
0000000X0000
00000000XX00
000000000000
000000000000
000000000LLL
000000000LLL
000000000LLL
