000000000000
000000000000
000000000000
000X000000XX
000000000000
000000000000
000000000000
00000000X000
000X00000000
000000000000
000000000000
000000000000
0000000X000X
00000000000X
000000000000
000000000000
000000000000
000000X00000
000000000LLL
000000000LLL
000000000LLL
