000000000000
000XX0000000
00X000000000
000000000000
000000000000
000000000000
000000000X00
00X000000000
000000000000
000000X00000
000000000000
000000000000
000000000000
000000000000
000000000000
000X0X000000
000000X00000
000000X00000
000000000LLL
000000000LLL
000000000LLL
