000000000000
000000000000
000000000000
0000000X0000
000000000000
00000000X000
000000000000
000000000000
000000000000
00000000X000
0000000000X0
000000000000
000000000000
000000000000
00000X0X0000
000000000000
000X00000000
00000X000000
00000X000LLL
000000000LLL
000000000LLL
