00000X000000
000000000000
X00000000000
000X00000000
0X00X0000000
000000000000
000000000000
X00000000000
000000000000
00X000000000
000000000000
000000000000
000000000000
000000000000
000000000000
00X000000000
00X000000000
000000000000
000000000LLL
0000X0000LLL
000000000LLL
