000000000000
000000000000
000000000000
0000000X0000
000000X00000
000000000000
000000000000
000000000000
000000000000
000000X00000
000000000000
000X0000X000
000X00000000
00000X000000
000000000000
0000000000X0
000000000000
000000000000
0000000X0LLL
000000000LLL
00000X000LLL
