000000000000
0000000X0000
00000X000000
000000000000
00X000000000
0X0000000000
000000000000
0X0000000000
000000000000
000000000000
000000000000
000000000000
0000000000X0
00X0X0000000
000000000000
000000000000
000000000000
000000000000
000000X00LLL
0000X0000LLL
000000000LLL
