000000000000
000000000000
0X00000000X0
000000000000
000000000000
000000000000
0000000X0000
000000000000
00X000000000
000000000000
000000000000
000000000000
X000000000X0
000000000000
00000000X000
000000000000
00000000000X
000000000000
000000000LLL
000000000LLL
000000X00LLL
