0000X0000000
000000000000
0000000000X0
00000000000X
00X000000000
000X00000000
000000000000
000000000000
000000000000
000000000000
000000000000
000000000000
0000X0000000
000000000000
00000000X000
0000X0000000
000000000000
000000000000
000000000LLL
000000000LLL
000000X00LLL
