000000000000
000000000000
000000000000
000000000000
000000000000
0000X0000000
000000000000
000000000000
00000000X000
000000X00000
000000000000
000000000000
000000000000
0000000XX000
0000X0000000
000000000X00
000000X00000
000000000000
000000000LLL
0000000X0LLL
000X00000LLL
