000X00000000
000000000000
000000000000
000000000000
0000000000X0
000000000000
000000000000
000000000000
000000X00000
000000000000
000000000X00
000000000000
000000000000
000000000000
000000000000
0000000000X0
000000000000
000000000000
0X0000000LLL
X000X0000LLL
0000000X0LLL
