000000000000
000000000000
000000000000
000000000000
000000000000
000000000X00
000000000000
0000X0000000
00000000XX00
000000000000
000000000000
000000000000
000X00X0X000
000000000000
0000000X0000
00000000X000
000000000000
00000000000X
000000000LLL
000000000LLL
000000000LLL
