000000000000
0000000000X0
000000000000
000X00000000
000000000000
00000000XX00
000000000000
0X0000000000
000000000000
000000000000
000000000X00
000000000000
000000000000
000000000000
000000000000
000000000000
000000000000
000000000000
000000000LLL
000000000LLL
00000000XLLL
