000000000000
000000X00000
000000000000
000000000000
000000000000
0X0000000000
X00000000000
000000000000
000000000000
000000000000
000000000000
000000000000
00000X00000X
00000X00X000
0000000X0000
000000000000
000000000000
000000000000
0X0000000LLL
000000X00LLL
000000000LLL
