000X00000000
000000000000
00000000000X
000X00000000
000000000000
000000000000
000000000000
0000000000X0
000000000000
000000000000
000000000000
X00000X00000
0000X0000000
00000000000X
00000000X000
000000000000
000000000000
000000000000
000000000LLL
000000000LLL
000000000LLL
