000000000000
00000X0000XX
000000000000
000000000000
000000000000
000000000000
00000000000X
000000000000
000000000000
00000000000X
00000X000000
000000000000
00000000X0X0
00000000X000
00X000000000
000000000000
000000000000
000000000000
000000000LLL
000000000LLL
000000000LLL
