000000000000
000000000000
000X0000000X
000000000000
000000000X00
0000X0000X00
000000000000
000000000000
000000000000
000000000000
000000000000
000000000000
000000000000
000000000000
000000000000
0X0000000000
000000000000
000X00000000
0X0000X00LLL
000000000LLL
000000000LLL
