000000000000
000000000000
000X00000000
000000000000
0X0000000000
000000000000
000000000000
000000000000
00000000000X
000000000X00
000000000000
000000000000
000000000000
000000000000
000X0000000X
00000X000X00
000000000000
000000000000
000000000LLL
0X0X00000LLL
000000000LLL
