000000000000
000000000000
000000000000
000000X00X00
0X0000000000
000000000000
00000X000000
000000000000
0X0000000000
0X0000000000
000000000000
000000000000
000000000000
000000000000
0X0000000000
000000000000
000000000000
000000000000
000X00000LLL
000000000LLL
0000X0000LLL
