000000000000
000000000000
000000000000
00000000X000
000000000000
000000000000
0000000000X0
0X0000000000
000000000000
000000000000
0X0000000000
00X000X00000
000000000000
000000000000
000000000000
00X0000000X0
0X0000000000
000000000000
0000000X0LLL
000000000LLL
000000000LLL
