000000000000
000X00000000
000000000000
000000000000
00000X000000
000000000000
000000000000
000000000000
000000000000
000000000000
00000X000000
000X00000000
00000X000000
00000000X000
000000000000
000000000000
000000000000
000000000X00
0000000X0LLL
X00000000LLL
00000000XLLL
