00000X000000
00000X0000X0
000000000000
000000000000
000000000000
0000000X0000
000000000000
000000000000
000000000000
000000000000
00000000X000
000000000000
000000000000
0X0000000000
000000000000
000000000000
0000X0000000
000000000000
000000000LLL
0X000X000LLL
00000000XLLL
