000000000000
00000000X000
000000000000
000000000000
000000000000
000000000000
000000000000
000000000000
000000000000
000000000000
00000000000X
000000000000
000000000000
00000000000X
0X0000X00000
000000000000
00X000X00000
000000000000
00X000000LLL
000000000LLL
000000000LLL
