00000000000X
000000X00000
000XX0000000
0X0000000000
0000000000X0
000000000000
000000000000
0XX0X0000000
000000000000
000000000000
000000000000
000000000000
000000000000
000000000000
000000000000
00X000000000
000000000000
000000000000
000000000LLL
000000000LLL
000000000LLL
