000000000000
000000000000
000000000000
000X00000000
000X00000000
000000000000
000000000000
000000000000
000000000000
000000000000
000000000000
000000000000
000000000000
000000000000
0000000X0000
00000000000X
0000X00X000X
000000000000
000X00000LLL
000000000LLL
0000X0000LLL
