000000000000
000000000000
000000000000
000000000000
000000000000
X000X000X000
00000X000000
000000000000
000000000000
000000000000
000000000000
000X00000000
000000000000
X00000000000
000000000000
000000000000
0XX000000000
0X0000X00000
000000000LLL
000000000LLL
000000000LLL
