000000000000
0X0000000X00
000000000000
000X00000000
000000000000
000000000000
000000000000
000000000000
000000000000
000000X00000
00X000000000
0000000000X0
0000000000X0
000000000000
000000000000
000000000000
000000000000
000000X00000
00000000XLLL
000X00000LLL
000000000LLL
