000000000000
000000000000
000000000000
000000000000
000000000000
0000000X0000
0000000000X0
000000000000
00X000000000
000000000000
000000X00000
000000000000
00000X000000
000000000000
0000000000X0
000000000000
000000000000
000000000000
000000000LLL
X0000X000LLL
0000000X0LLL
