000000000000
000000000000
000000000X00
000000000000
000000000000
000000000000
000000000000
000000000000
000000000000
000X000X0000
000000000000
000000X00000
0000X0000000
000000000000
0X0000000000
00000000X000
00000000000X
00000000X000
000000000LLL
000000000LLL
000000000LLL
