000000000000
000000000000
000000000000
00000000000X
X0000000000X
X00000000000
000000000000
000000000000
000000000000
0X0000000000
000000000000
000000000000
000000000000
X00000000000
000000000000
00000000000X
000000000000
000000000000
0000X0000LLL
0000X0000LLL
00X000000LLL
