0000X0000000
000000000000
000000000X00
000000000000
000000000000
000000000000
000000000000
00000000000X
000000000000
000000000000
000000000000
000000000000
000000000000
X000000X000X
000000000000
000000000X00
000000000000
000000000X00
000000000LLL
000000000LLL
0XX000000LLL
