000000000000
000000000000
000000000X00
00000000X00X
000000000000
000000000000
000X00000000
000000000000
0000X0000000
000000000000
000000000000
000000000000
0000000000X0
000000000000
0000000XX000
0X0000000000
0000000000X0
000000000000
000000000LLL
000000000LLL
000000000LLL
