000000000000
000000000000
X00000000000
0000000X000X
000000000000
X00000000000
00000X000X00
000000000000
000000000000
000000000000
000000000000
000000000X00
000000000000
000000000000
000000000000
000000000000
000000000000
000000000000
00000000XLLL
000000000LLL
000000000LLL
