000000000000
000000000000
000000000000
000000000000
000000000000
000000000000
000000000000
000000000000
000000000000
0000X0000000
0X0000000000
000000000000
00X000000000
X00000000000
000000000000
00000X0X0000
00000000000X
000000000000
00000X000LLL
00000X000LLL
00000X000LLL
