000000000000
000000000X00
00X000000000
000000000000
000000000000
000000X00000
000000000000
0X0000000000
000000000000
00000000X000
000X00X00000
000000000000
0X000X000000
000000000000
000000000000
000000000000
000000000000
000000000000
000000000LLL
0000000X0LLL
000000000LLL
