000000000000
0000000X0000
00000X000000
000X00000000
0000X0000000
000000000000
000000000000
000000000000
000000000000
00000000000X
000000000000
000000000000
000000000000
000000000000
0000X0000000
000000000000
00000000X0X0
000000000000
000000X0XLLL
000000000LLL
000000000LLL
