000000000000
00000000X000
000000000000
0000X0000000
X00000000000
000000000000
000000000000
0000X0000000
000000000000
00X00000X000
000000000000
000000000000
000000000000
00000000000X
000X00000000
000000000000
000000000000
000000000000
000000X00LLL
00000000XLLL
000000000LLL
