00000000X0X0
000000000000
000000000000
000000000000
000000000000
0X0000000000
00000X000000
000000000000
000000000000
0000000000X0
000000000000
000000000000
000000000000
000000000000
X00000000000
000000000000
0000XX000000
000000000000
000000000LLL
X00000X00LLL
000000000LLL
