000000000000
000000000000
000000000000
X00000000000
000000000000
000000000X00
0000X0000000
0000000X0000
000000000000
000000000000
000000000000
00000X000000
00X000000000
X00000000000
00000X000000
0000000X0000
000000000000
000000000000
000000000LLL
X00000000LLL
000000000LLL
