000X00000000
0000X0000000
00000000000X
000000000000
X00000000000
000X00000000
000000000000
000000000000
000000000000
000000000000
000000000000
000000000000
000000000000
0000X0000000
00X0X0000000
000000000000
000000000000
00000000000X
000000000LLL
000000000LLL
000000000LLL
