000000000000
000000000000
000000000000
000000000000
000000000000
000000000000
000000X00000
0000X0000000
000000000000
000000000X00
000000000000
00X0X000X000
000000000000
000000000000
000000000000
00X000000000
000000000000
0000000X0000
00X000000LLL
00000X000LLL
000000000LLL
