000X0X000X00
000000000000
000000000000
000000000000
000000000000
000000000000
000000000000
000000000000
000000000000
000000000000
000000000000
000000000000
0000X0000000
00000000X0X0
000000000000
00000X000000
0X0000000000
000000000000
000000000LLL
000000X00LLL
00X000000LLL
