000000000000
000000000000
00000000X000
000000000000
000000000000
000000000000
000000X00000
00000000000X
000000000000
000000000X00
000000000000
000000000000
00000000X000
00000X000000
0000000000X0
00000X000000
000000000000
000X0000X000
000000000LLL
000000000LLL
000000000LLL
