000000000000
000000000000
0X0000000000
0000000X0000
000000000000
00000XX00000
0X0000000000
000000000000
000X00000000
000000000000
000000000000
000000000X00
000000000000
00000000000X
000000000000
000000X00000
000000000000
000000000000
000000000LLL
00000000XLLL
000000000LLL
