000000000000
000000X00X00
000000000000
0000000000X0
X00000X00000
0000X0000000
0000000X0000
000000000X00
000000000000
000000000000
000000000000
000000000000
0000X0000000
000000000000
0000000X0000
000000000000
000000000000
000000000000
000000000LLL
000000000LLL
000000000LLL
