X00000000000
000000000000
000000000000
000000000000
000000000000
0X0000000000
000000000000
000000000000
0000000000X0
X00000000000
00000000X000
0000000X0000
X0000000000X
000X00000000
000000000000
000000X00000
000000000000
000000000000
000000000LLL
000000000LLL
000000000LLL
