000000000000
000000000000
0000X0000000
000X00000000
000000000000
000000000000
00000X000000
0000000X0000
0000000000X0
000000000000
000000000000
000000000000
000000000000
0X0000000000
000000000000
00000X000000
000000000000
000000000000
000000000LLL
000X00000LLL
X00000X00LLL
