000000000000
00000X000000
000000X00000
0X0000000000
000000000000
000000000000
X00000000000
000000000000
000000000000
0000000X0000
000000000000
000000000000
000000000000
000X00X00000
000000000000
000000000000
000000000000
000000000000
000000000LLL
00XX00000LLL
000000000LLL
