000000000000
00000000X000
000000000000
000000000X00
000000000000
000000000000
000000000000
000000000000
X00000000000
000000000000
000X00000X00
000000000000
00000X000000
000000000000
000000000000
000000000000
0X0000000000
000X00000000
0000000X0LLL
000000000LLL
0000X0000LLL
