000000000000
000000000000
000000000000
0X0000000000
00000000X00X
000000000000
000000000000
000000000000
000000000000
000000000000
000000000000
X00000000000
000000000000
000000000000
000000000000
X00000000X00
000000000000
00000000000X
00000000XLLL
000000000LLL
X00000000LLL
