000000000000
00000000000X
000000000000
000000000000
000000000000
000000000000
00000X000000
000000000000
0XX000000000
000000000000
0X0000000000
00000XX00000
00X000000000
000000000000
000000000000
000000000000
0X0000000000
000000000000
000000000LLL
000000000LLL
000000000LLL
