00000000X000
000000000000
000X000X000X
000000000000
000000000000
000000000000
0X0000000000
000000000000
000000000000
000000000000
000XX0000000
000000000000
000000000000
000000000000
000000000000
000000000000
0X00X0000000
0000000000X0
000000000LLL
000000000LLL
000000000LLL
