000000000000
000000000000
000000X0X00X
000000000000
000000000000
X0000000X000
000000000000
000000000000
X00000000000
000000000000
000000000000
00000000000X
X00000000000
000000000000
000000000000
00000X000000
000000000000
000000000000
000000000LLL
000000000LLL
0000X0000LLL
