000000000000
000000000000
0000X000000X
000000000000
000000000000
00000000X000
0000000000X0
000000000000
000000000000
000X00000000
000000000X00
00000X0000X0
000000000000
000000000000
000000000000
000000000000
000000X00000
000000000000
000000000LLL
000000000LLL
00000000XLLL
