000000000000
000000000000
000000000000
000000000000
000000000000
000000000000
0000000000X0
000000000000
00000X0000X0
X00000000000
000000000000
000000000000
0000000X0000
00000000X000
0000X0000X00
0000X0000000
000000000000
000000000000
000000000LLL
000000000LLL
000000000LLL
