000000000000
000000000000
000X00000000
000000000000
000000000000
000X00000000
00X000000000
000000000000
000000000000
000000000000
000000000000
0000X0000X00
000000X00000
000000000000
00000000X000
000000000000
000000000000
000000000X00
000000000LLL
000000X00LLL
00000000XLLL
