000000000000
000000000000
000000000000
000000000000
0X0000000000
000000000000
000000000000
000X0000000X
000000000000
00000X000000
0000000X0000
000000000000
000000000000
000000000X00
000000000X00
000000000000
000000000000
000000000000
000000000LLL
000X00000LLL
000000X00LLL
