000000000000
00000000X000
000000000000
000000000000
000000000000
0000X00X0000
000000000X00
00000000000X
000000000000
000000000X00
000000000000
000000000000
00000000X000
000000000000
0X000000XX00
000000000000
000000000000
000000000000
000000000LLL
000000000LLL
000000000LLL
