00000X00X000
000000000000
00X000000000
000000000000
000000000000
00X000000000
000000000000
00000000000X
0000X0000000
000X00X00000
000000000000
000000000000
000000000000
000000000000
0X0000000000
000000000000
000000000000
000000000000
000000000LLL
000000000LLL
0000000X0LLL
