000000X0X000
000000000000
000000000000
000000000000
000000X00000
00000X00X000
000000000000
000000000000
000000000000
0000000000X0
000000000000
000000X00000
000000000000
000000000000
000000000000
000000000000
000000000000
000000X0000X
0X0000000LLL
000000000LLL
000000000LLL
