000000000000
000000000000
000000000000
000000000000
000000000X00
00000X000000
000000000000
00X000000000
0000000X0000
00000000X000
000000000000
000000000000
00000X000000
00X000000000
000000000000
000000000000
000000000000
000000000000
000000X00LLL
000000000LLL
000000000LLL
