000000000000
000000000000
0X0000000000
000000000000
0000000X0000
000000000000
000000000000
000000000000
000000000000
X0000X000000
0000000X000X
X00000000000
000000000000
000X00000000
000000000000
000000000000
000000X00000
000000000000
000000000LLL
000000000LLL
0X0000000LLL
