00000000000X
000000000000
000000000000
000000000000
000000000000
00000000000X
000000000000
000000000000
000000000000
000000000000
0X000X000000
000000000000
000000000000
0X0000000000
000000000000
00000X00X000
0000000X0000
000X00000000
000000000LLL
000X00000LLL
000000000LLL
