000000000000
000000000000
00X000000000
0000000000XX
00000000X000
000000000000
000000000000
X0000X000000
000000000000
0000X0000000
000000000000
000000000000
000000000000
000000000000
000000000000
000000000000
000000000000
0000X0000000
000000000LLL
00000000XLLL
000000X00LLL
