000000000000
000000000000
0000000X00X0
000000000000
000000000000
000000000000
000000000000
000000000000
000000000000
000000X00000
000000000000
000000000000
000000000XX0
000000000000
000000000000
X0000000000X
000000000000
000000X0000X
000000000LLL
000000000LLL
000000000LLL
