000000000000
000000000000
0000000X0000
000000000000
000000X00000
000000000000
0000X0000000
00X000000000
000000000000
000000000000
000000000000
000000000000
00000000000X
0X0000000000
000X00000000
00000000000X
000000000000
000000000000
00000000XLLL
0000000X0LLL
000000000LLL
