000000000000
000000000X00
000000000000
000000000000
000000000000
000000000000
000000000000
000000000000
0X0000000000
00000X00000X
000000000000
000000000000
000000000X00
000000000000
000000000000
00000X000000
0X0000X00000
000000000000
000000000LLL
000000000LLL
000000000LLL
