000000000X00
000000000000
000000000000
000000000000
000000000000
0000X0000000
00X00X000000
000000000000
00000000000X
0000X00X0000
000000000000
0X0000000000
000000000000
000000000000
000000000000
0000X0000000
000000000000
000000000000
000000000LLL
00000X000LLL
000000000LLL
