000000000000
000000000000
000000000000
000000000000
000000000000
X00000000000
000000000000
000000000000
000000000000
0X0000000000
000000000000
000000000000
00000X00X0X0
00000000000X
000000000000
000000000000
000000000000
00X000000000
X00000000LLL
00000X000LLL
000000000LLL
