000000000000
0000X0000000
000000000000
0000X0000000
000000000000
000000000000
X00000000000
000000000000
0X0000000000
000000000000
000000000000
000000000000
000000000000
0000X0000X00
000000000000
000000000000
000000000000
000000000000
00000000XLLL
0000000X0LLL
0000X0000LLL
