000X0000X000
000000000000
000000000000
000000000000
000000000000
000000000000
00XX00000000
0000000000X0
000000000000
0000000000X0
000000000000
000000000000
000000000000
000000000000
000000000000
0000000000X0
000000000000
0000X0000000
000000000LLL
00X000000LLL
000000X00LLL
