000000000XX0
000000000000
000000000000
000000000000
000000000000
000000000000
0000000X0000
000000000000
000000X00000
000X00000000
000000000000
000000000000
000000000000
000000X00000
00000000X000
00000000X000
000000000000
000000000000
000000000LLL
X00000000LLL
X00000000LLL
