000000000000
000000000000
000000000000
000000000000
000000000000
000000000X00
00000X000000
000000000000
000000000000
000000000000
000000000000
000000000000
000000000000
00X0X0000000
000000X00000
00000000X000
00000X000000
0000000X0000
000000000LLL
0000000X0LLL
000000000LLL
