000000000000
000000000000
000000000000
000000000000
000000000000
000000000000
000X00000000
X00000000000
0000000000X0
000000000000
000000000000
0000000000X0
000000000000
00000000X000
000000000000
000000000000
X00X000000X0
000000000000
000000000LLL
00000000XLLL
000000000LLL
