000000000000
000000000X00
000000000000
000000000000
000000000X00
000000000000
000X00000000
000000000000
000000000000
00000X000000
000000000000
000000000000
000000000000
0000000000XX
0000X0000000
00X00000000X
000000000000
000000000000
000000000LLL
000000000LLL
000000000LLL
