000000000000
0000X0000000
0X0000000000
000000000000
0000X0000000
00000000000X
000000000000
0X0000000000
000000000000
000000000000
000000000000
000000000000
00000000X000
000000000000
000000000000
000000000000
00000000000X
000000000X00
00000X000LLL
000000000LLL
0X0000000LLL
