00X00000X000
0000000X0000
000000000000
000000000000
00X000000000
000000000000
00000000XX00
000000000X00
000X00000000
000000000000
000000000000
000000000000
000X00000000
000000000000
000000000000
000000000000
000000000000
000000000000
0000000X0LLL
000000000LLL
000000000LLL
