000000000000
00000000000X
X00000000000
0000000X0000
000000000000
0000000X0000
0000000000X0
00000X000000
000000000000
000000000000
000000000000
000000000000
0X000000X000
000000000000
000000000000
000000000000
000000000000
000000000000
00000000XLLL
000000000LLL
000000000LLL
