000000000X00
000000000000
000000000000
000000000000
000000X00X0X
000000000000
000000000X00
000000000000
000000000000
000000000000
000000000000
000000000000
000000000000
0000000000X0
000000000000
00000000000X
000000000X00
00X000000000
000000000LLL
000000000LLL
000000000LLL
