0000X0000000
000000000000
000000000000
000000000000
000000X00000
000000000000
000000000000
000000000000
000000X0XX00
000000000000
000000000000
000000000000
000000000000
000000000000
00000X0000X0
00000X000000
000000000000
000000000000
0000X0000LLL
000000000LLL
000000000LLL
