0000XX00X0X0
000000000000
000000000000
000000000000
000000000000
00000000000X
000000000000
000000000000
0000000X0000
000000000000
00X0X0000000
000000000000
000000000000
000000000000
000000000000
000000000000
000000000000
0000X0000000
000000000LLL
000000000LLL
000000000LLL
