000000000000
000000000000
000000000000
0X0000X0X000
000000000000
000000000000
00000X000000
000X00000000
000000000000
000000000000
0X0000X00000
000000000000
000000000000
000000000000
000000000000
0X0000000000
000000000000
000000000000
0000X0000LLL
000000000LLL
X00000000LLL
