000000000000
000000000000
00000X000000
000000000000
000000000000
0000X0000000
000000000000
00X000000000
0000000000X0
000000000000
000000000000
000000000X00
000000000000
0000X0000000
000000000000
000000000X00
0X0000000000
000000000000
000000000LLL
000000000LLL
X00000000LLL
