0000X0000000
000000000000
000000000000
000000000000
000000000000
000000X00000
000000000000
X0000000000X
000000000000
000000000000
000X000000X0
000000000000
000000000000
000000X00000
000000000000
000000000000
000000000000
000000000000
X000X0000LLL
000000000LLL
000000000LLL
