000000000000
000000X00000
000000000000
000000000000
000000000000
000000000000
00000000000X
000000000000
0000X0000000
000X00000000
000000000000
000000000000
000000X00000
00X00X000000
000000000000
0000000X0000
000000000000
000000000000
000000000LLL
X00000000LLL
0000X0000LLL
