000000000000
X00000000000
000000000000
000000000000
000000000000
0X0000000000
0000X0000X00
000000000000
0000X0000000
000000000000
000000000000
000000X0X000
000000000000
000000000000
000000000000
000X00000000
000000000000
0X0000000000
000000000LLL
00X000000LLL
000000000LLL
