000000000000
000000000X00
00000XX00000
0000000000X0
000000000000
000000X000X0
000000000000
000000000000
000000000000
000000000000
000000000000
00000X000000
X00000000000
000000000000
000000000000
000000000000
000000000000
000000000000
00000000XLLL
000000000LLL
000000000LLL
