000000X00000
0000000X0000
XX0000000000
000000000000
000000000000
00000000000X
000000000000
00000X000000
000000000000
000000000000
000000000000
000000000000
000000000000
000000000000
00X000000X00
000000000000
0000X0000000
000000000000
000000000LLL
000000000LLL
000X00000LLL
