000000000000
000000000000
00000X000000
000000X00000
00X000X00000
000000X00000
000000000000
000000000000
000000000000
000000000000
0000X0000000
000000000000
00000000X000
000000000X00
000000000000
000000000000
000000000000
000000000000
000000000LLL
000000000LLL
00000000XLLL
