0X0000000000
0000XX000000
000000000000
000000000000
000000000000
00000X000X00
000000000000
000000000000
000000000000
000000000000
000000000000
000000000000
00000000X000
000000000000
000000000000
000X00000000
X00000000000
000000000000
00000000XLLL
00X000000LLL
000000000LLL
