000000000000
000000000X00
000000000000
00000000000X
000000000000
000000000000
00X000000000
000000000000
000000000000
000000000000
000000000000
00X000000000
000000000000
0000000000X0
00000000XXX0
000000000000
00000000X000
000000000000
000000000LLL
000000000LLL
000000000LLL
