000000000000
00000000000X
00000000X000
00000000X000
00000000X000
000000000000
000000000000
000000000000
000000000000
000000000000
000000000000
000000000000
000000000000
000000000000
X0000000X000
000000000000
000000000000
00000X000000
000000000LLL
000000000LLL
000000000LLL
