00X000XX0000
0X000X0000X0
000000000000
X00X00000000
000000000000
000000000000
000000000000
000000000000
000000000000
000000000000
000000000000
000000000000
000000000000
000000000000
X00000000000
000000000000
000000000000
000000000000
000000000LLL
000X00000LLL
000000000LLL
