000000000000
000000000000
000000000000
000000000000
000000X00000
00X000000000
000000000000
0000000XX000
000000000000
0000000000X0
00000000X000
0000000X0000
000000000000
000000000000
000000000000
0000000000X0
0000000000X0
000000000000
000000000LLL
000000000LLL
000000000LLL
