000000000000
00000X000X00
000000000000
000000000000
000000000000
0X0000000000
00000X000000
000000000000
00000X0X0000
000000000000
000000000000
000000000000
000000000000
000000000000
000000000000
0X0000000000
0X0000000000
000000000000
000000000LLL
000000000LLL
00X000000LLL
