000000000000
000000000000
0X0000000000
0000X0X00000
000000000000
000000000000
000000000000
0000000000X0
X00X00000000
000000000000
000000000000
00000000X000
000000000000
000000000000
000000000000
000000000000
0000000000X0
00X0000000X0
000000000LLL
000000000LLL
000000000LLL
