0000000000X0
000000000000
00X000000000
000000000000
000X000000X0
000000000000
00X000000000
0000000X00X0
000000000000
000000000000
000000000000
00000000000X
000000000000
000000000000
000000000000
000000000000
000000000000
00000000X000
00000X000LLL
000000000LLL
000000000LLL
