0000X0000000
X00X000X0000
0X00X0000000
000000000000
000000000000
000000000000
000000000000
000000000000
000000000000
000000000000
000000000000
000000000000
0X0000000000
000000000000
000000000X00
000000000000
000000000000
000000000000
00000000XLLL
0000000X0LLL
000000000LLL
