X00000000000
000000000000
00X0000000X0
00000000X000
000000000000
000000000000
000000000X00
000000000000
000000000000
000000000000
0X0000000000
000000000000
000000000000
000000000000
000000000000
000000000X00
0000X000000X
000000000000
000000000LLL
000X00000LLL
000000000LLL
