000000000000
000X00000000
000000000000
000000000000
000000000000
000000000000
00000000000X
000000000000
0000000X0000
0000X0000000
0000X0000000
000X00000000
000000000000
000000000000
000X00000000
000000000000
000000000000
000000000000
X00000000LLL
000X00X00LLL
000000000LLL
