000000000000
000000000000
000000000000
000000000X00
X00000000000
000000000000
000000000000
000000000000
000000000000
000000000000
000000000000
000X00000000
0000X0000000
0000X0000000
000000000000
000000000000
000000000000
000000000000
000000000LLL
0X00000XXLLL
000000000LLL
