000000000000
000000000000
000000000000
000000000000
0000000X0000
000000000000
0X000000000X
0000X0000000
0000000000X0
000000000000
0000X0000000
000000000000
0000000000X0
000XX0000000
000000000000
000000000000
000000000000
000000000000
000000000LLL
000X00000LLL
000000000LLL
