000000000000
X00000000000
000000000000
000000000000
000000000000
0000000X0000
00000000000X
000000000000
00X000X0000X
000000000000
00000X00000X
0000X0000000
000000000000
000000000000
000000000000
000000000000
000000000000
000000000000
000000000LLL
000000000LLL
000000000LLL
