000000000000
000000000000
000000000000
X00000000000
000000000000
000000000000
00000000X000
000000000000
000000000000
000000000000
000000000000
00000X000000
000000000000
000000000000
000000000000
0000X0000000
X00000000000
00000000X000
000000000LLL
00000X000LLL
0000000X0LLL
