000000000000
000000000000
000000000000
000000000000
000000000000
000000000000
0000X0000000
0X0000X0X000
000000000000
000000000000
000000000000
0X0000000000
000000000X00
X00000000000
000000000000
00X000000000
0000000X0000
000000000000
000000000LLL
000000000LLL
00000000XLLL
