000000000000
000000000000
000000000000
000000000000
000000000000
00000X000000
000000XX0000
000000000000
000000000000
000000000000
000000X00000
000000000000
000000000000
000000000000
000000000000
00000X000000
000000X00000
00000000000X
0X0000000LLL
000X00000LLL
X00000000LLL
