000000000000
000000000000
000000000X00
000000000000
000000000000
000000000000
000000000000
0X0000000000
000000000000
000X00000000
00X000000000
000000000000
0000000000X0
000000000000
00000X000000
000000000000
000000000000
000000000000
000000000LLL
0X0000000LLL
000000000LLL
