0000000X0000
000000000000
00X000000000
0000X0000000
000000000000
000X00000000
X00000000000
000000000000
000000000000
000000000000
0000X0000000
0000X0000000
000X00000000
000000000000
000000000000
0000000X0000
000000000000
000000000000
000000000LLL
00000000XLLL
000000000LLL
