000000000000
000000000000
000000000000
000000000000
000000000000
00000000X000
000000000000
000000000X00
000000000000
000000000000
00000000000X
000000000000
000000000000
000000000000
000000000000
00000000X0X0
000000000000
000000000000
000000000LLL
0000000X0LLL
000X0X000LLL
