000000000000
000000000X00
000X00000000
000000000000
000000000000
000000000000
000000000000
000000000000
000000000000
000000000000
000X00000000
000000000000
00000000X000
00000X00000X
000000000000
0000X0000000
000000000000
000000X00000
000X00000LLL
000000000LLL
000000000LLL
