000000000000
000000000000
000000000000
000000000000
000000000000
000000000000
00X000000000
000000000X00
X00000000000
000000000000
000000000000
X00000000000
000000000000
000000000000
000000XX0000
000000000000
0000000000X0
000000000X00
000000000LLL
0000X0000LLL
0000X0000LLL
