000000000000
0X0000000000
000000000000
00000000000X
000000000000
0000X0000000
000000000000
000000X00000
000000000000
0000000X0000
000000000000
000000000000
000000000000
000000000000
000000000000
00000X000000
0000000000X0
0X0000X00000
000000000LLL
X00000000LLL
000000000LLL
