000000000000
00000000X000
000000000000
000000000000
000000000000
000000000000
000000000000
000000000000
000000000000
000000000000
000000X00000
0000000000X0
000000000000
000000000XX0
000000000X0X
000000000000
000X00000000
000000000000
000000000LLL
0000X0000LLL
000000000LLL
