0000000000X0
000000000000
X00000000000
000000000000
000000X00000
000000000000
000000000000
000000000000
000000000000
000000000000
0000000X0000
000000000000
000000000000
0X0000000000
000X00000000
000000000000
0000X000X000
000000000000
000000X00LLL
00000000XLLL
000000000LLL
