000X00000000
000000000000
00000000X000
0X0000000000
0X0000000000
000000000000
000000000X00
000000000000
000000000000
000000000000
000000000000
00000000000X
0000000000X0
000000000000
000000000X00
000000000000
000000000X00
000000000000
000000000LLL
0000X0000LLL
000000000LLL
