########################
#OOOOOOOOOOOOOOOOOOOOOO#
#OOOOOOOOOOOOOOOOOOOOOO#
#OOOOOOOOOOOOOOOOOOOOOO#
#OOOOOOOOOOOOOOOOOOOOOO#
#OOOOOOOOOOOOOOOOOOOOOO#
#OOOOOOOOOOOOOOOOOOOOOO#
#OOOOXXOOOOOOOOOOOOOOOO#
#OOOOXXOOOOOOOOOOOOOOOO#
#OOOOXXOOOOOOOOOOOOOOOO#
#OOOOXXOOOOOOOOOOOOOOOO#
#OOOOOOOOOOOOOOOOOOOLLL#
#OOOOOOOOOOOOOOOOOOOLLL#
#OOOOOOOOOOOOOOOOOOOOOO#
#OOOOOOOOOOOOOOOOOOOOOO#
#OOOOOOOOOOOOOOOOOOOOOO#
#OOOOOOOOOOOOOOOOOOOOOO#
#OOOOOOOOOOOOOOOOOOOOOO#
#OOOOOOOOOOOOOOOOOOOOOO#
#OOOOOOOOOOOOOOOOOOOOOO#
#OOOOOOOOOOOOOOOOOOOOOO#
#OOOOOOOOOOOOOOOOOOOOOO#
########################
########################
########################
########################
########################
########################
########################
########################
########################
########################
########################
########################
########################
########################
########################
########################
########################
########################
########################
